<html>
<body>
<table>
<tr><td>Fernando Abad*	0</td></tr>
<tr><td>Fernando Abad*	0</td></tr>
<tr><td>Jose Abreu	25</td></tr>
<tr><td>A.J. Achter	0</td></tr>
<tr><td>Dustin Ackley*	0</td></tr>
<tr><td>Cristhian Adames#	2</td></tr>
<tr><td>Austin Adams	0</td></tr>
<tr><td>Matt Adams*	16</td></tr>
<tr><td>Tim Adleman	0</td></tr>
<tr><td>Ehire Adrianza#	2</td></tr>
<tr><td>Jesus Aguilar	0</td></tr>
<tr><td>Nick Ahmed	4</td></tr>
<tr><td>Andrew Albers	0</td></tr>
<tr><td>Matt Albers*	0</td></tr>
<tr><td>Hanser Alberto	0</td></tr>
<tr><td>Al Alburquerque	0</td></tr>
<tr><td>Arismendy Alcantara#	0</td></tr>
<tr><td>Raul Alcantara	0</td></tr>
<tr><td>Scott Alexander*	0</td></tr>
<tr><td>Jorge Alfaro	0</td></tr>
<tr><td>Cody Allen	0</td></tr>
<tr><td>Abraham Almonte#	1</td></tr>
<tr><td>Albert Almora	3</td></tr>
<tr><td>Yonder Alonso*	7</td></tr>
<tr><td>Dan Altavilla	0</td></tr>
<tr><td>Aaron Altherr	4</td></tr>
<tr><td>Jose Altuve	24</td></tr>
<tr><td>Dariel Alvarez	0</td></tr>
<tr><td>Dario Alvarez*	0</td></tr>
<tr><td>Dario Alvarez*	0</td></tr>
<tr><td>Jose Alvarez*	0</td></tr>
<tr><td>Pedro Alvarez*	22</td></tr>
<tr><td>Alexi Amarista*	0</td></tr>
<tr><td>Brett Anderson*	0</td></tr>
<tr><td>Chase Anderson	0</td></tr>
<tr><td>Cody Anderson	0</td></tr>
<tr><td>Tim Anderson	9</td></tr>
<tr><td>Tyler Anderson*	1</td></tr>
<tr><td>Robert Andino	0</td></tr>
<tr><td>Matt Andriese	0</td></tr>
<tr><td>Elvis Andrus	8</td></tr>
<tr><td>Dustin Antolin	0</td></tr>
<tr><td>Nori Aoki*	4</td></tr>
<tr><td>Jayson Aquino*	0</td></tr>
<tr><td>Elvis Araujo*	0</td></tr>
<tr><td>Chris Archer	0</td></tr>
<tr><td>Orlando Arcia	4</td></tr>
<tr><td>Oswaldo Arcia*	4</td></tr>
<tr><td>Oswaldo Arcia*	2</td></tr>
<tr><td>Oswaldo Arcia*	0</td></tr>
<tr><td>Oswaldo Arcia*	2</td></tr>
<tr><td>Nolan Arenado	41</td></tr>
<tr><td>Shawn Armstrong	0</td></tr>
<tr><td>Jonathan Aro	0</td></tr>
<tr><td>Jake Arrieta	2</td></tr>
<tr><td>Cody Asche*	4</td></tr>
<tr><td>Alec Asher	0</td></tr>
<tr><td>Carlos Asuaje*	0</td></tr>
<tr><td>Tyler Austin	5</td></tr>
<tr><td>Alex Avila*	7</td></tr>
<tr><td>Luis Avilan*	0</td></tr>
<tr><td>Mike Aviles	1</td></tr>
<tr><td>John Axford	0</td></tr>
<tr><td>Erick Aybar#	2</td></tr>
<tr><td>Erick Aybar#	1</td></tr>
<tr><td>Javier Baez	14</td></tr>
<tr><td>Pedro Baez	0</td></tr>
<tr><td>Andrew Bailey	0</td></tr>
<tr><td>Andrew Bailey	0</td></tr>
<tr><td>Homer Bailey	0</td></tr>
<tr><td>Jett Bandy	8</td></tr>
<tr><td>Johnny Barbato	0</td></tr>
<tr><td>Austin Barnes	0</td></tr>
<tr><td>Brandon Barnes	0</td></tr>
<tr><td>Danny Barnes*	0</td></tr>
<tr><td>Jacob Barnes	0</td></tr>
<tr><td>Matt Barnes	0</td></tr>
<tr><td>Tony Barnette	0</td></tr>
<tr><td>Darwin Barney	4</td></tr>
<tr><td>Tucker Barnhart#	7</td></tr>
<tr><td>Kyle Barraclough	0</td></tr>
<tr><td>Jake Barrett	0</td></tr>
<tr><td>Chris Bassitt	0</td></tr>
<tr><td>Antonio Bastardo	0</td></tr>
<tr><td>Antonio Bastardo	0</td></tr>
<tr><td>Trevor Bauer	0</td></tr>
<tr><td>Buddy Baumann*	0</td></tr>
<tr><td>Jose Bautista	22</td></tr>
<tr><td>Chris Beck	0</td></tr>
<tr><td>Gordon Beckham	5</td></tr>
<tr><td>Gordon Beckham	0</td></tr>
<tr><td>Tim Beckham	5</td></tr>
<tr><td>Cam Bedrosian	0</td></tr>
<tr><td>Matt Belisle	0</td></tr>
<tr><td>Josh Bell#	3</td></tr>
<tr><td>Brandon Belt*	17</td></tr>
<tr><td>Carlos Beltran#	22</td></tr>
<tr><td>Carlos Beltran#	7</td></tr>
<tr><td>Adrian Beltre	32</td></tr>
<tr><td>Andrew Benintendi*	2</td></tr>
<tr><td>Joaquin Benoit	0</td></tr>
<tr><td>Joaquin Benoit	0</td></tr>
<tr><td>James Beresford*	0</td></tr>
<tr><td>Christian Bergman	0</td></tr>
<tr><td>Jose Berrios	0</td></tr>
<tr><td>Dellin Betances	0</td></tr>
<tr><td>Christian Bethancourt	6</td></tr>
<tr><td>Chad Bettis	0</td></tr>
<tr><td>Mookie Betts	31</td></tr>
<tr><td>Joe Biagini	0</td></tr>
<tr><td>Ty Blach	0</td></tr>
<tr><td>Charlie Blackmon*	29</td></tr>
<tr><td>Aaron Blair	0</td></tr>
<tr><td>Andres Blanco#	4</td></tr>
<tr><td>Gregor Blanco*	1</td></tr>
<tr><td>Joe Blanton	0</td></tr>
<tr><td>Jabari Blash	3</td></tr>
<tr><td>Michael Blazek	0</td></tr>
<tr><td>Richard Bleier*	0</td></tr>
<tr><td>Jerry Blevins*	0</td></tr>
<tr><td>Xander Bogaerts	21</td></tr>
<tr><td>Mike Bolsinger	0</td></tr>
<tr><td>Emilio Bonifacio#	0</td></tr>
<tr><td>Julio Borbon*	0</td></tr>
<tr><td>Wilfredo Boscan	0</td></tr>
<tr><td>Buddy Boshers*	0</td></tr>
<tr><td>Justin Bour*	15</td></tr>
<tr><td>Peter Bourjos	5</td></tr>
<tr><td>Michael Bourn*	3</td></tr>
<tr><td>Michael Bourn*	2</td></tr>
<tr><td>Matthew Bowman	0</td></tr>
<tr><td>Brad Boxberger	0</td></tr>
<tr><td>Matt Boyd*	0</td></tr>
<tr><td>Blaine Boyer	0</td></tr>
<tr><td>Brad Brach	0</td></tr>
<tr><td>Silvino Bracho	0</td></tr>
<tr><td>Archie Bradley	0</td></tr>
<tr><td>Jackie Bradley*	26</td></tr>
<tr><td>Jed Bradley*	0</td></tr>
<tr><td>Michael Brantley*	0</td></tr>
<tr><td>Steven Brault*	0</td></tr>
<tr><td>Ryan Braun	30</td></tr>
<tr><td>Alex Bregman	8</td></tr>
<tr><td>Bryce Brentz	1</td></tr>
<tr><td>Craig Breslow*	0</td></tr>
<tr><td>Austin Brice	0</td></tr>
<tr><td>Parker Bridwell	0</td></tr>
<tr><td>Reid Brignac*	0</td></tr>
<tr><td>Socrates Brito*	4</td></tr>
<tr><td>Zach Britton*	0</td></tr>
<tr><td>Mike Broadway	0</td></tr>
<tr><td>Trevor Brown	5</td></tr>
<tr><td>Jonathan Broxton	0</td></tr>
<tr><td>Keon Broxton	9</td></tr>
<tr><td>Jay Bruce*	25</td></tr>
<tr><td>Jay Bruce*	8</td></tr>
<tr><td>Kris Bryant	39</td></tr>
<tr><td>Jake Buchanan	0</td></tr>
<tr><td>Clay Buchholz*	0</td></tr>
<tr><td>Ryan Buchter*	0</td></tr>
<tr><td>Madison Bumgarner	3</td></tr>
<tr><td>Dylan Bundy#	0</td></tr>
<tr><td>Enrique Burgos	0</td></tr>
<tr><td>Sean Burnett*	0</td></tr>
<tr><td>Andy Burns	0</td></tr>
<tr><td>Billy Burns#	0</td></tr>
<tr><td>Billy Burns#	0</td></tr>
<tr><td>Emmanuel Burriss#	0</td></tr>
<tr><td>Matt Buschmann	0</td></tr>
<tr><td>Matt Bush	0</td></tr>
<tr><td>Nick Buss*	1</td></tr>
<tr><td>Drew Butera	4</td></tr>
<tr><td>Billy Butler	4</td></tr>
<tr><td>Billy Butler	1</td></tr>
<tr><td>Eddie Butler	0</td></tr>
<tr><td>Byron Buxton	10</td></tr>
<tr><td>Marlon Byrd	5</td></tr>
<tr><td>Asdrubal Cabrera#	23</td></tr>
<tr><td>Mauricio Cabrera	0</td></tr>
<tr><td>Melky Cabrera#	14</td></tr>
<tr><td>Miguel Cabrera	38</td></tr>
<tr><td>Ramon Cabrera#	3</td></tr>
<tr><td>Trevor Cahill	0</td></tr>
<tr><td>Lorenzo Cain	9</td></tr>
<tr><td>Matt Cain	1</td></tr>
<tr><td>Kole Calhoun*	18</td></tr>
<tr><td>Arquimedes Caminero	0</td></tr>
<tr><td>Arquimedes Caminero	0</td></tr>
<tr><td>Eric Campbell	1</td></tr>
<tr><td>Leonel Campos	0</td></tr>
<tr><td>Vicente Campos	0</td></tr>
<tr><td>Jeimer Candelario#	0</td></tr>
<tr><td>Mark Canha	3</td></tr>
<tr><td>Robinson Cano*	39</td></tr>
<tr><td>Chris Capuano*	0</td></tr>
<tr><td>Matt Carasiti	0</td></tr>
<tr><td>Stephen Cardullo	2</td></tr>
<tr><td>Matt Carpenter*	21</td></tr>
<tr><td>Carlos Carrasco	0</td></tr>
<tr><td>Ezequiel Carrera*	6</td></tr>
<tr><td>Scott Carroll	0</td></tr>
<tr><td>Chris Carter	41</td></tr>
<tr><td>Curt Casali	8</td></tr>
<tr><td>Andrew Cashner	0</td></tr>
<tr><td>Andrew Cashner	0</td></tr>
<tr><td>Santiago Casilla	0</td></tr>
<tr><td>Nick Castellanos	18</td></tr>
<tr><td>Rusney Castillo	0</td></tr>
<tr><td>Welington Castillo	14</td></tr>
<tr><td>Daniel Castro	0</td></tr>
<tr><td>Jason Castro*	11</td></tr>
<tr><td>Miguel Castro	0</td></tr>
<tr><td>Starlin Castro	21</td></tr>
<tr><td>Gavin Cecchini	0</td></tr>
<tr><td>Brett Cecil	0</td></tr>
<tr><td>Darrell Ceciliani*	0</td></tr>
<tr><td>Xavier Cedeno*	0</td></tr>
<tr><td>Juan Centeno*	3</td></tr>
<tr><td>Francisco Cervelli	1</td></tr>
<tr><td>Hunter Cervenka*	0</td></tr>
<tr><td>Hunter Cervenka*	0</td></tr>
<tr><td>Yoenis Cespedes	31</td></tr>
<tr><td>Luis Cessa	0</td></tr>
<tr><td>Jhoulys Chacin	0</td></tr>
<tr><td>Jhoulys Chacin	0</td></tr>
<tr><td>Andrew Chafin	0</td></tr>
<tr><td>Joba Chamberlain	0</td></tr>
<tr><td>Aroldis Chapman*	0</td></tr>
<tr><td>Aroldis Chapman*	0</td></tr>
<tr><td>Kevin Chapman*	0</td></tr>
<tr><td>J.T. Chargois#	0</td></tr>
<tr><td>Tyler Chatwood	0</td></tr>
<tr><td>Jesse Chavez	0</td></tr>
<tr><td>Jesse Chavez	0</td></tr>
<tr><td>Wei-Yin Chen*	0</td></tr>
<tr><td>Robinson Chirinos	9</td></tr>
<tr><td>Lonnie Chisenhall*	8</td></tr>
<tr><td>Ji-Man Choi*	5</td></tr>
<tr><td>Shin-Soo Choo*	7</td></tr>
<tr><td>Tony Cingrani*	0</td></tr>
<tr><td>Steve Cishek	0</td></tr>
<tr><td>Alex Claudio*	0</td></tr>
<tr><td>Paul Clemens	0</td></tr>
<tr><td>Paul Clemens	0</td></tr>
<tr><td>Steve Clevenger*	1</td></tr>
<tr><td>Mike Clevinger	0</td></tr>
<tr><td>Tyler Clippard	0</td></tr>
<tr><td>Tyler Clippard	0</td></tr>
<tr><td>Jason Coats	1</td></tr>
<tr><td>Alex Cobb	0</td></tr>
<tr><td>Chris Coghlan*	5</td></tr>
<tr><td>Chris Coghlan*	1</td></tr>
<tr><td>Phil Coke*	0</td></tr>
<tr><td>Phil Coke*	0</td></tr>
<tr><td>Chris Colabello	0</td></tr>
<tr><td>A.J. Cole	0</td></tr>
<tr><td>Gerrit Cole	1</td></tr>
<tr><td>Louis Coleman	0</td></tr>
<tr><td>Tyler Collins*	4</td></tr>
<tr><td>Josh Collmenter	0</td></tr>
<tr><td>Josh Collmenter	0</td></tr>
<tr><td>Alex Colome	0</td></tr>
<tr><td>Bartolo Colon	1</td></tr>
<tr><td>Christian Colon	1</td></tr>
<tr><td>Joseph Colon	0</td></tr>
<tr><td>Gerardo Concepcion*	0</td></tr>
<tr><td>Michael Conforto*	12</td></tr>
<tr><td>Hank Conger#	3</td></tr>
<tr><td>Adam Conley*	0</td></tr>
<tr><td>Willson Contreras	12</td></tr>
<tr><td>Patrick Corbin*	0</td></tr>
<tr><td>Carlos Correa	20</td></tr>
<tr><td>Jarred Cosart	0</td></tr>
<tr><td>Jarred Cosart	0</td></tr>
<tr><td>Caleb Cotham	0</td></tr>
<tr><td>Jharel Cotton	0</td></tr>
<tr><td>Daniel Coulombe*	0</td></tr>
<tr><td>Kaleb Cowart#	1</td></tr>
<tr><td>Collin Cowgill	0</td></tr>
<tr><td>Zack Cozart	16</td></tr>
<tr><td>Tyler Cravy	1</td></tr>
<tr><td>Brandon Crawford*	12</td></tr>
<tr><td>Carl Crawford*	0</td></tr>
<tr><td>Coco Crisp#	11</td></tr>
<tr><td>Coco Crisp#	2</td></tr>
<tr><td>Kyle Crockett*	0</td></tr>
<tr><td>C.J. Cron	16</td></tr>
<tr><td>Nelson Cruz	43</td></tr>
<tr><td>Tony Cruz	0</td></tr>
<tr><td>Johnny Cueto	0</td></tr>
<tr><td>William Cuevas	0</td></tr>
<tr><td>Charlie Culberson	1</td></tr>
<tr><td>Brandon Cunniff	0</td></tr>
<tr><td>Todd Cunningham#	0</td></tr>
<tr><td>Zac Curtis*	0</td></tr>
<tr><td>Cheslor Cuthbert	12</td></tr>
<tr><td>Chase d'Arnaud	1</td></tr>
<tr><td>Travis d'Arnaud	4</td></tr>
<tr><td>David Dahl*	7</td></tr>
<tr><td>Tyler Danish	0</td></tr>
<tr><td>John Danks*	0</td></tr>
<tr><td>Yu Darvish	1</td></tr>
<tr><td>Matt Davidson	0</td></tr>
<tr><td>Zach Davies	0</td></tr>
<tr><td>Chris Davis*	38</td></tr>
<tr><td>Ike Davis*	0</td></tr>
<tr><td>Khris Davis	42</td></tr>
<tr><td>Rajai Davis	12</td></tr>
<tr><td>Wade Davis	0</td></tr>
<tr><td>Grant Dayton*	0</td></tr>
<tr><td>Alejandro De Aza*	6</td></tr>
<tr><td>Ivan De Jesus	1</td></tr>
<tr><td>Joel De La Cruz#	0</td></tr>
<tr><td>Jorge De La Rosa*	0</td></tr>
<tr><td>Rubby De La Rosa	0</td></tr>
<tr><td>Jose De Leon	0</td></tr>
<tr><td>Abel De Los Santos	0</td></tr>
<tr><td>Pat Dean*	0</td></tr>
<tr><td>Jaff Decker*	0</td></tr>
<tr><td>Jacob deGrom*	0</td></tr>
<tr><td>Steve Delabar	0</td></tr>
<tr><td>Randall Delgado	0</td></tr>
<tr><td>Matt den Dekker*	1</td></tr>
<tr><td>Matt Dermody	0</td></tr>
<tr><td>Daniel Descalso*	8</td></tr>
<tr><td>Anthony DeSclafani	0</td></tr>
<tr><td>Delino DeShields	4</td></tr>
<tr><td>Ian Desmond	22</td></tr>
<tr><td>Odrisamer Despaigne	0</td></tr>
<tr><td>Odrisamer Despaigne	0</td></tr>
<tr><td>Ross Detwiler	0</td></tr>
<tr><td>Ross Detwiler	0</td></tr>
<tr><td>Chris Devenski	0</td></tr>
<tr><td>Scott Diamond*	0</td></tr>
<tr><td>Aledmys Diaz	17</td></tr>
<tr><td>Dayan Diaz	0</td></tr>
<tr><td>Edwin Diaz	0</td></tr>
<tr><td>Elias Diaz	0</td></tr>
<tr><td>Jumbo Diaz	0</td></tr>
<tr><td>Alex Dickerson*	10</td></tr>
<tr><td>Corey Dickerson*	24</td></tr>
<tr><td>R.A. Dickey	0</td></tr>
<tr><td>Jake Diekman*	0</td></tr>
<tr><td>Derek Dietrich*	7</td></tr>
<tr><td>Wilmer Difo#	1</td></tr>
<tr><td>Jose Dominguez	0</td></tr>
<tr><td>Matt Dominguez	0</td></tr>
<tr><td>Josh Donaldson	37</td></tr>
<tr><td>Sean Doolittle*	0</td></tr>
<tr><td>Brian Dozier	42</td></tr>
<tr><td>Hunter Dozier	0</td></tr>
<tr><td>Kyle Drabek	0</td></tr>
<tr><td>Oliver Drake	0</td></tr>
<tr><td>Stephen Drew*	8</td></tr>
<tr><td>Brandon Drury	16</td></tr>
<tr><td>Lucas Duda*	7</td></tr>
<tr><td>Brian Duensing*	0</td></tr>
<tr><td>Tyler Duffey	0</td></tr>
<tr><td>Danny Duffy*	0</td></tr>
<tr><td>Matt Duffy	4</td></tr>
<tr><td>Matt Duffy	0</td></tr>
<tr><td>Matt Duffy	1</td></tr>
<tr><td>Zach Duke*	0</td></tr>
<tr><td>Zach Duke*	0</td></tr>
<tr><td>Ryan Dull	0</td></tr>
<tr><td>Mike Dunn*	0</td></tr>
<tr><td>Adam Duvall	33</td></tr>
<tr><td>Jarrod Dyson*	1</td></tr>
<tr><td>Sam Dyson	0</td></tr>
<tr><td>Adam Eaton*	14</td></tr>
<tr><td>Josh Edgin	0</td></tr>
<tr><td>Carl Edwards	0</td></tr>
<tr><td>Zach Eflin	0</td></tr>
<tr><td>Cody Ege*	0</td></tr>
<tr><td>Cody Ege*	0</td></tr>
<tr><td>Brett Eibner	3</td></tr>
<tr><td>Brett Eibner	3</td></tr>
<tr><td>Jerad Eickhoff	0</td></tr>
<tr><td>Roenis Elias*	0</td></tr>
<tr><td>Brian Ellington	0</td></tr>
<tr><td>A.J. Ellis	1</td></tr>
<tr><td>A.J. Ellis	1</td></tr>
<tr><td>Jacoby Ellsbury*	9</td></tr>
<tr><td>Jake Elmore	0</td></tr>
<tr><td>Edwin Encarnacion	42</td></tr>
<tr><td>Nathan Eovaldi	0</td></tr>
<tr><td>Robbie Erlin	0</td></tr>
<tr><td>Jake Esch	0</td></tr>
<tr><td>Alcides Escobar	7</td></tr>
<tr><td>Eduardo Escobar#	6</td></tr>
<tr><td>Edwin Escobar*	0</td></tr>
<tr><td>Yunel Escobar	5</td></tr>
<tr><td>Danny Espinosa#	24</td></tr>
<tr><td>Carlos Estevez	0</td></tr>
<tr><td>Marco Estrada	0</td></tr>
<tr><td>Andre Ethier*	1</td></tr>
<tr><td>Dana Eveland*	0</td></tr>
<tr><td>Jeurys Familia	0</td></tr>
<tr><td>Buck Farmer*	0</td></tr>
<tr><td>Danny Farquhar	0</td></tr>
<tr><td>Andrew Faulkner	0</td></tr>
<tr><td>Taylor Featherston	0</td></tr>
<tr><td>Tim Federowicz	0</td></tr>
<tr><td>Scott Feldman*	0</td></tr>
<tr><td>Scott Feldman*	0</td></tr>
<tr><td>Michael Feliz	0</td></tr>
<tr><td>Neftali Feliz	0</td></tr>
<tr><td>Jose Fernandez	0</td></tr>
<tr><td>Prince Fielder*	8</td></tr>
<tr><td>Josh Fields	0</td></tr>
<tr><td>Josh Fields	0</td></tr>
<tr><td>Casey Fien	0</td></tr>
<tr><td>Casey Fien	0</td></tr>
<tr><td>Mike Fiers	0</td></tr>
<tr><td>Cole Figueroa*	0</td></tr>
<tr><td>Brandon Finnegan*	0</td></tr>
<tr><td>Doug Fister*	0</td></tr>
<tr><td>Ryan Flaherty*	3</td></tr>
<tr><td>Yohan Flande*	0</td></tr>
<tr><td>Kendry Flores	0</td></tr>
<tr><td>Ramon Flores*	2</td></tr>
<tr><td>Wilmer Flores	16</td></tr>
<tr><td>Pedro Florimon#	0</td></tr>
<tr><td>Dylan Floro*	0</td></tr>
<tr><td>Tyler Flowers	8</td></tr>
<tr><td>Gavin Floyd	0</td></tr>
<tr><td>Brian Flynn*	0</td></tr>
<tr><td>Mike Foltynewicz	0</td></tr>
<tr><td>Logan Forsythe	20</td></tr>
<tr><td>Dexter Fowler#	13</td></tr>
<tr><td>Maikel Franco	25</td></tr>
<tr><td>Jeff Francoeur	7</td></tr>
<tr><td>Jeff Francoeur	0</td></tr>
<tr><td>Nick Franklin#	6</td></tr>
<tr><td>Adam Frazier*	2</td></tr>
<tr><td>Todd Frazier	40</td></tr>
<tr><td>Freddie Freeman*	34</td></tr>
<tr><td>Mike Freeman*	0</td></tr>
<tr><td>Mike Freeman*	0</td></tr>
<tr><td>Sam Freeman	0</td></tr>
<tr><td>David Freese	13</td></tr>
<tr><td>Carlos Frias	0</td></tr>
<tr><td>Christian Friedrich	0</td></tr>
<tr><td>Eric Fryer	0</td></tr>
<tr><td>Eric Fryer	0</td></tr>
<tr><td>Reymond Fuentes*	0</td></tr>
<tr><td>Carson Fulmer	0</td></tr>
<tr><td>Michael Fulmer	0</td></tr>
<tr><td>Yovani Gallardo	0</td></tr>
<tr><td>Joey Gallo*	1</td></tr>
<tr><td>Freddy Galvis#	20</td></tr>
<tr><td>Eddie Gamboa	0</td></tr>
<tr><td>Ben Gamel*	0</td></tr>
<tr><td>Ben Gamel*	1</td></tr>
<tr><td>John Gant	0</td></tr>
<tr><td>Adonis Garcia	14</td></tr>
<tr><td>Avisail Garcia	12</td></tr>
<tr><td>Greg Garcia*	3</td></tr>
<tr><td>Jaime Garcia*	0</td></tr>
<tr><td>Leury Garcia#	1</td></tr>
<tr><td>Luis Garcia	0</td></tr>
<tr><td>Yimi Garcia	0</td></tr>
<tr><td>Brett Gardner*	7</td></tr>
<tr><td>Dustin Garneau	1</td></tr>
<tr><td>Perci Garner	0</td></tr>
<tr><td>Ryan Garton	0</td></tr>
<tr><td>Matt Garza	0</td></tr>
<tr><td>Evan Gattis	32</td></tr>
<tr><td>Kevin Gausman*	0</td></tr>
<tr><td>Cory Gearrin	0</td></tr>
<tr><td>Dillon Gee	0</td></tr>
<tr><td>Steve Geltz	0</td></tr>
<tr><td>Scooter Gennett*	14</td></tr>
<tr><td>Craig Gentry	0</td></tr>
<tr><td>Gonzalez Germen	0</td></tr>
<tr><td>Johnny Giavotella	6</td></tr>
<tr><td>Kyle Gibson	0</td></tr>
<tr><td>Ken Giles	0</td></tr>
<tr><td>Conor Gillaspie*	6</td></tr>
<tr><td>Cole Gillespie	0</td></tr>
<tr><td>Sean Gilmartin*	0</td></tr>
<tr><td>Chris Gimenez	4</td></tr>
<tr><td>Lucas Giolito	0</td></tr>
<tr><td>Chad Girodo*	0</td></tr>
<tr><td>Mychal Givens	0</td></tr>
<tr><td>Tyler Glasnow*	0</td></tr>
<tr><td>Koda Glover	0</td></tr>
<tr><td>Zack Godley	0</td></tr>
<tr><td>Erik Goeddel	0</td></tr>
<tr><td>Tyler Goeddel	4</td></tr>
<tr><td>David Goforth	0</td></tr>
<tr><td>Ryan Goins*	3</td></tr>
<tr><td>Paul Goldschmidt	24</td></tr>
<tr><td>Yan Gomes	9</td></tr>
<tr><td>Carlos Gomez	5</td></tr>
<tr><td>Carlos Gomez	8</td></tr>
<tr><td>Jeanmar Gomez	0</td></tr>
<tr><td>Adrian Gonzalez*	18</td></tr>
<tr><td>Carlos Gonzalez*	25</td></tr>
<tr><td>Chi Chi Gonzalez	0</td></tr>
<tr><td>Erik Gonzalez	0</td></tr>
<tr><td>Gio Gonzalez	0</td></tr>
<tr><td>Marwin Gonzalez#	13</td></tr>
<tr><td>Miguel Gonzalez	0</td></tr>
<tr><td>Severino Gonzalez	0</td></tr>
<tr><td>Brian Goodwin*	0</td></tr>
<tr><td>Nick Goody	0</td></tr>
<tr><td>Alex Gordon*	17</td></tr>
<tr><td>Dee Gordon*	1</td></tr>
<tr><td>Terrance Gore	0</td></tr>
<tr><td>Tom Gorzelanny	0</td></tr>
<tr><td>Anthony Gose*	2</td></tr>
<tr><td>Tuffy Gosewisch	3</td></tr>
<tr><td>Philip Gosselin	2</td></tr>
<tr><td>Trevor Gott	0</td></tr>
<tr><td>Matt Grace*	0</td></tr>
<tr><td>J.R. Graham	0</td></tr>
<tr><td>Yasmani Grandal#	27</td></tr>
<tr><td>Curtis Granderson*	30</td></tr>
<tr><td>Juan Graterol	0</td></tr>
<tr><td>Kendall Graveman	0</td></tr>
<tr><td>Jon Gray	0</td></tr>
<tr><td>Sonny Gray	0</td></tr>
<tr><td>Chad Green*	0</td></tr>
<tr><td>Grant Green	1</td></tr>
<tr><td>Shane Greene	0</td></tr>
<tr><td>Luke Gregerson*	0</td></tr>
<tr><td>Didi Gregorius*	20</td></tr>
<tr><td>Zack Greinke	0</td></tr>
<tr><td>Randal Grichuk	24</td></tr>
<tr><td>A.J. Griffin	0</td></tr>
<tr><td>Jason Grilli	0</td></tr>
<tr><td>Jason Grilli	0</td></tr>
<tr><td>Justin Grimm	0</td></tr>
<tr><td>Robbie Grossman#	11</td></tr>
<tr><td>Robert Gsellman	0</td></tr>
<tr><td>Mayckol Guaipe	0</td></tr>
<tr><td>Deolis Guerra	0</td></tr>
<tr><td>Javy Guerra	0</td></tr>
<tr><td>Junior Guerra	0</td></tr>
<tr><td>Tayron Guerrero	0</td></tr>
<tr><td>Jason Gurka*	0</td></tr>
<tr><td>Yulieski Gurriel	3</td></tr>
<tr><td>Jandel Gustave	0</td></tr>
<tr><td>Franklin Gutierrez	14</td></tr>
<tr><td>Brandon Guyer	7</td></tr>
<tr><td>Brandon Guyer	2</td></tr>
<tr><td>Jedd Gyorko	30</td></tr>
<tr><td>Jesse Hahn	0</td></tr>
<tr><td>David Hale	0</td></tr>
<tr><td>Cody Hall	0</td></tr>
<tr><td>Cole Hamels*	0</td></tr>
<tr><td>Billy Hamilton#	3</td></tr>
<tr><td>Jason Hammel	0</td></tr>
<tr><td>Brad Hand*	0</td></tr>
<tr><td>Ryan Hanigan	1</td></tr>
<tr><td>Mitch Haniger	5</td></tr>
<tr><td>Alen Hanson#	0</td></tr>
<tr><td>J.A. Happ*	0</td></tr>
<tr><td>Blaine Hardy*	0</td></tr>
<tr><td>J.J. Hardy	9</td></tr>
<tr><td>Bryce Harper*	24</td></tr>
<tr><td>Lucas Harrell#	0</td></tr>
<tr><td>Lucas Harrell#	0</td></tr>
<tr><td>Will Harris	0</td></tr>
<tr><td>Josh Harrison	4</td></tr>
<tr><td>Donnie Hart*	0</td></tr>
<tr><td>Matt Harvey	0</td></tr>
<tr><td>Chris Hatcher#	0</td></tr>
<tr><td>Steve Hathaway*	0</td></tr>
<tr><td>Drew Hayes	0</td></tr>
<tr><td>Jeremy Hazelbaker*	12</td></tr>
<tr><td>Chase Headley#	14</td></tr>
<tr><td>Ryon Healy	13</td></tr>
<tr><td>Andrew Heaney*	0</td></tr>
<tr><td>Adeiny Hechavarria	3</td></tr>
<tr><td>Austin Hedges	0</td></tr>
<tr><td>Chris Heisey	9</td></tr>
<tr><td>Ben Heller	0</td></tr>
<tr><td>Jeremy Hellickson	0</td></tr>
<tr><td>Heath Hembree	0</td></tr>
<tr><td>Jim Henderson*	0</td></tr>
<tr><td>Kyle Hendricks	0</td></tr>
<tr><td>Liam Hendriks	0</td></tr>
<tr><td>Guillermo Heredia	1</td></tr>
<tr><td>Cesar Hernandez#	6</td></tr>
<tr><td>David Hernandez	0</td></tr>
<tr><td>Enrique Hernandez	7</td></tr>
<tr><td>Felix Hernandez	0</td></tr>
<tr><td>Gorkys Hernandez	2</td></tr>
<tr><td>Marco Hernandez*	1</td></tr>
<tr><td>Oscar Hernandez	1</td></tr>
<tr><td>Roberto Hernandez	0</td></tr>
<tr><td>Teoscar Hernandez	4</td></tr>
<tr><td>Kelvin Herrera	0</td></tr>
<tr><td>Odubel Herrera*	15</td></tr>
<tr><td>Chris Herrmann*	6</td></tr>
<tr><td>Frank Herrmann*	0</td></tr>
<tr><td>Keith Hessler*	0</td></tr>
<tr><td>Keith Hessler*	0</td></tr>
<tr><td>Chris Heston	0</td></tr>
<tr><td>Jason Heyward*	7</td></tr>
<tr><td>Aaron Hicks#	8</td></tr>
<tr><td>John Hicks	0</td></tr>
<tr><td>Aaron Hill	8</td></tr>
<tr><td>Aaron Hill	2</td></tr>
<tr><td>Rich Hill*	0</td></tr>
<tr><td>Rich Hill*	0</td></tr>
<tr><td>Dalier Hinojosa	0</td></tr>
<tr><td>Luke Hochevar	0</td></tr>
<tr><td>Jeff Hoffman	0</td></tr>
<tr><td>Bryan Holaday	2</td></tr>
<tr><td>Bryan Holaday	0</td></tr>
<tr><td>Jonathan Holder	0</td></tr>
<tr><td>Derek Holland#	0</td></tr>
<tr><td>Matt Holliday	20</td></tr>
<tr><td>Brock Holt*	7</td></tr>
<tr><td>Tyler Holt	0</td></tr>
<tr><td>Destin Hood	1</td></tr>
<tr><td>J.J. Hoover	0</td></tr>
<tr><td>Eric Hosmer*	25</td></tr>
<tr><td>T.J. House	0</td></tr>
<tr><td>Ryan Howard*	25</td></tr>
<tr><td>J.P. Howell*	0</td></tr>
<tr><td>Jared Hoying*	0</td></tr>
<tr><td>James Hoyt	0</td></tr>
<tr><td>Daniel Hudson	0</td></tr>
<tr><td>David Huff#	0</td></tr>
<tr><td>Jared Hughes	0</td></tr>
<tr><td>Phil Hughes	0</td></tr>
<tr><td>Nick Hundley	10</td></tr>
<tr><td>Cedric Hunter*	1</td></tr>
<tr><td>Tommy Hunter	0</td></tr>
<tr><td>Tommy Hunter	0</td></tr>
<tr><td>Jason Hursh	0</td></tr>
<tr><td>Drew Hutchison*	0</td></tr>
<tr><td>Drew Hutchison*	0</td></tr>
<tr><td>Chris Iannetta	7</td></tr>
<tr><td>Jose Iglesias	4</td></tr>
<tr><td>Raisel Iglesias	0</td></tr>
<tr><td>Ender Inciarte*	3</td></tr>
<tr><td>Omar Infante	0</td></tr>
<tr><td>Hernan Iribarren*	0</td></tr>
<tr><td>Hisashi Iwakuma	0</td></tr>
<tr><td>Austin Jackson	0</td></tr>
<tr><td>Edwin Jackson	0</td></tr>
<tr><td>Edwin Jackson	0</td></tr>
<tr><td>Luke Jackson	0</td></tr>
<tr><td>Paul Janish	0</td></tr>
<tr><td>Travis Jankowski*	2</td></tr>
<tr><td>Kenley Jansen#	0</td></tr>
<tr><td>John Jaso*	8</td></tr>
<tr><td>Jon Jay*	2</td></tr>
<tr><td>Jeremy Jeffress	0</td></tr>
<tr><td>Jeremy Jeffress	0</td></tr>
<tr><td>Tyrell Jenkins	0</td></tr>
<tr><td>Dan Jennings*	0</td></tr>
<tr><td>Desmond Jennings	7</td></tr>
<tr><td>Kyle Jensen	2</td></tr>
<tr><td>Kevin Jepsen	0</td></tr>
<tr><td>Kevin Jepsen	0</td></tr>
<tr><td>Ubaldo Jimenez	0</td></tr>
<tr><td>Chris Johnson	5</td></tr>
<tr><td>Erik Johnson	0</td></tr>
<tr><td>Erik Johnson	0</td></tr>
<tr><td>Jim Johnson	0</td></tr>
<tr><td>Kelly Johnson*	1</td></tr>
<tr><td>Kelly Johnson*	9</td></tr>
<tr><td>Micah Johnson*	0</td></tr>
<tr><td>Steve Johnson	0</td></tr>
<tr><td>Adam Jones	29</td></tr>
<tr><td>JaCoby Jones	0</td></tr>
<tr><td>Nate Jones	0</td></tr>
<tr><td>Caleb Joseph	0</td></tr>
<tr><td>Tommy Joseph	21</td></tr>
<tr><td>Matthew Joyce*	13</td></tr>
<tr><td>Aaron Judge	4</td></tr>
<tr><td>Taylor Jungmann	0</td></tr>
<tr><td>Tommy Kahnle	0</td></tr>
<tr><td>Ryan Kalish*	0</td></tr>
<tr><td>Jung Ho Kang	21</td></tr>
<tr><td>Nate Karns	0</td></tr>
<tr><td>Munenori Kawasaki*	0</td></tr>
<tr><td>Scott Kazmir*	0</td></tr>
<tr><td>Keone Kela	0</td></tr>
<tr><td>Shawn Kelley	0</td></tr>
<tr><td>Carson Kelly	0</td></tr>
<tr><td>Casey Kelly	0</td></tr>
<tr><td>Don Kelly*	0</td></tr>
<tr><td>Joe Kelly	0</td></tr>
<tr><td>Ty Kelly#	1</td></tr>
<tr><td>Matt Kemp	23</td></tr>
<tr><td>Matt Kemp	12</td></tr>
<tr><td>Tony Kemp*	1</td></tr>
<tr><td>Howie Kendrick	8</td></tr>
<tr><td>Ian Kennedy	0</td></tr>
<tr><td>Logan Kensing	0</td></tr>
<tr><td>Max Kepler*	17</td></tr>
<tr><td>Clayton Kershaw*	0</td></tr>
<tr><td>Dallas Keuchel*	0</td></tr>
<tr><td>Spencer Kieboom	0</td></tr>
<tr><td>Dean Kiekhefer*	0</td></tr>
<tr><td>Kevin Kiermaier*	12</td></tr>
<tr><td>Hyun Soo Kim*	6</td></tr>
<tr><td>Craig Kimbrel	0</td></tr>
<tr><td>Ian Kinsler	28</td></tr>
<tr><td>Brandon Kintzler	0</td></tr>
<tr><td>Jason Kipnis*	23</td></tr>
<tr><td>Michael Kirkman*	0</td></tr>
<tr><td>Michael Kirkman*	0</td></tr>
<tr><td>Patrick Kivlehan	1</td></tr>
<tr><td>Patrick Kivlehan	0</td></tr>
<tr><td>Phil Klein	0</td></tr>
<tr><td>Phil Klein	0</td></tr>
<tr><td>Corey Kluber	0</td></tr>
<tr><td>Corey Knebel	0</td></tr>
<tr><td>Matt Koch*	0</td></tr>
<tr><td>Tom Koehler	0</td></tr>
<tr><td>George Kontos	0</td></tr>
<tr><td>Erik Kratz	0</td></tr>
<tr><td>Erik Kratz	1</td></tr>
<tr><td>Ian Krol*	0</td></tr>
<tr><td>Chad Kuhl	0</td></tr>
<tr><td>Tommy La Stella*	2</td></tr>
<tr><td>John Lackey	0</td></tr>
<tr><td>Tyler Ladendorf	0</td></tr>
<tr><td>Juan Lagares	3</td></tr>
<tr><td>Junior Lake	1</td></tr>
<tr><td>Blake Lalli*	0</td></tr>
<tr><td>Ryan LaMarre	0</td></tr>
<tr><td>Jake Lamb*	29</td></tr>
<tr><td>John Lamb*	0</td></tr>
<tr><td>Andrew Lambo*	0</td></tr>
<tr><td>Mat Latos	0</td></tr>
<tr><td>Mat Latos	1</td></tr>
<tr><td>Derek Law	0</td></tr>
<tr><td>Brett Lawrie	12</td></tr>
<tr><td>Tommy Layne*	0</td></tr>
<tr><td>Tommy Layne*	0</td></tr>
<tr><td>Mike Leake	0</td></tr>
<tr><td>Wade LeBlanc*	0</td></tr>
<tr><td>Wade LeBlanc*	0</td></tr>
<tr><td>Jose Leclerc	0</td></tr>
<tr><td>Dae-ho Lee	14</td></tr>
<tr><td>DJ LeMahieu	11</td></tr>
<tr><td>Arnold Leon	0</td></tr>
<tr><td>Sandy Leon#	7</td></tr>
<tr><td>Dominic Leone	0</td></tr>
<tr><td>Jon Lester*	0</td></tr>
<tr><td>Colby Lewis	0</td></tr>
<tr><td>Adam Liberatore*	0</td></tr>
<tr><td>Pat Light	0</td></tr>
<tr><td>Pat Light	0</td></tr>
<tr><td>Tim Lincecum*	0</td></tr>
<tr><td>Adam Lind*	20</td></tr>
<tr><td>Francisco Lindor#	15</td></tr>
<tr><td>Francisco Liriano*	1</td></tr>
<tr><td>Francisco Liriano*	0</td></tr>
<tr><td>Jose Lobaton#	3</td></tr>
<tr><td>Kyle Lobstein*	0</td></tr>
<tr><td>Jeff Locke*	0</td></tr>
<tr><td>Adam Loewen*	0</td></tr>
<tr><td>Boone Logan	0</td></tr>
<tr><td>Kyle Lohse	0</td></tr>
<tr><td>James Loney*	9</td></tr>
<tr><td>Evan Longoria	36</td></tr>
<tr><td>Javier Lopez*	0</td></tr>
<tr><td>Rafael Lopez*	0</td></tr>
<tr><td>Reynaldo Lopez	0</td></tr>
<tr><td>Michael Lorenzen	1</td></tr>
<tr><td>David Lough*	0</td></tr>
<tr><td>Aaron Loup*	0</td></tr>
<tr><td>Mark Lowe*	0</td></tr>
<tr><td>Jed Lowrie#	2</td></tr>
<tr><td>Jonathan Lucroy	13</td></tr>
<tr><td>Jonathan Lucroy	11</td></tr>
<tr><td>Cory Luebke	0</td></tr>
<tr><td>Seth Lugo	0</td></tr>
<tr><td>Jordan Lyles	0</td></tr>
<tr><td>Tyler Lyons*	0</td></tr>
<tr><td>Dixon Machado	0</td></tr>
<tr><td>Manny Machado	37</td></tr>
<tr><td>Ryan Madson*	0</td></tr>
<tr><td>Kenta Maeda	1</td></tr>
<tr><td>Matt Magill	0</td></tr>
<tr><td>Damien Magnifico	0</td></tr>
<tr><td>Greg Mahle*	0</td></tr>
<tr><td>Mikie Mahtook	3</td></tr>
<tr><td>Luke Maile	3</td></tr>
<tr><td>Martin Maldonado	8</td></tr>
<tr><td>Sean Manaea*	0</td></tr>
<tr><td>Trey Mancini	3</td></tr>
<tr><td>Seth Maness	0</td></tr>
<tr><td>Jeff Manship	0</td></tr>
<tr><td>Joe Mantiply	0</td></tr>
<tr><td>Manuel Margot	0</td></tr>
<tr><td>Jhan Marinez	0</td></tr>
<tr><td>Jhan Marinez	0</td></tr>
<tr><td>Michael Mariot	0</td></tr>
<tr><td>Jake Marisnick	5</td></tr>
<tr><td>Nick Markakis*	13</td></tr>
<tr><td>Justin Marks*	0</td></tr>
<tr><td>Matt Marksberry*	0</td></tr>
<tr><td>German Marquez	0</td></tr>
<tr><td>Deven Marrero	0</td></tr>
<tr><td>Evan Marshall	0</td></tr>
<tr><td>Jefry Marte	15</td></tr>
<tr><td>Kelvin Marte	0</td></tr>
<tr><td>Ketel Marte#	1</td></tr>
<tr><td>Starling Marte	9</td></tr>
<tr><td>Cody Martin	0</td></tr>
<tr><td>Leonys Martin*	15</td></tr>
<tr><td>Rafael Martin	0</td></tr>
<tr><td>Russell Martin	20</td></tr>
<tr><td>Carlos Martinez	0</td></tr>
<tr><td>J.D. Martinez	22</td></tr>
<tr><td>Jose Martinez	0</td></tr>
<tr><td>Michael Martinez#	0</td></tr>
<tr><td>Michael Martinez#	1</td></tr>
<tr><td>Nick Martinez*	0</td></tr>
<tr><td>Victor Martinez#	27</td></tr>
<tr><td>Darin Mastroianni	0</td></tr>
<tr><td>Jeff Mathis	2</td></tr>
<tr><td>Brian Matusz*	0</td></tr>
<tr><td>Brian Matusz*	0</td></tr>
<tr><td>Steven Matz	0</td></tr>
<tr><td>Joe Mauer*	11</td></tr>
<tr><td>Brandon Maurer	0</td></tr>
<tr><td>Bruce Maxwell*	1</td></tr>
<tr><td>Trevor May	0</td></tr>
<tr><td>Cameron Maybin	4</td></tr>
<tr><td>Mike Mayers	0</td></tr>
<tr><td>Nomar Mazara*	20</td></tr>
<tr><td>Vin Mazzaro	0</td></tr>
<tr><td>Zach McAllister	0</td></tr>
<tr><td>Matt McBride	0</td></tr>
<tr><td>Brian McCann*	20</td></tr>
<tr><td>James McCann	12</td></tr>
<tr><td>Brandon McCarthy	0</td></tr>
<tr><td>Kevin McCarthy	0</td></tr>
<tr><td>Lance McCullers*	0</td></tr>
<tr><td>Andrew McCutchen	24</td></tr>
<tr><td>T.J. McFarland*	0</td></tr>
<tr><td>Jake McGee*	0</td></tr>
<tr><td>Casey McGehee	0</td></tr>
<tr><td>Dustin McGowan	0</td></tr>
<tr><td>Collin McHugh	0</td></tr>
<tr><td>Michael McKenry	0</td></tr>
<tr><td>Kris Medlen#	0</td></tr>
<tr><td>Adalberto Mejia	0</td></tr>
<tr><td>Mark Melancon	0</td></tr>
<tr><td>Mark Melancon	0</td></tr>
<tr><td>Tim Melville	0</td></tr>
<tr><td>Yohander Mendez*	0</td></tr>
<tr><td>Daniel Mengden	0</td></tr>
<tr><td>Jordy Mercer	11</td></tr>
<tr><td>Whit Merrifield	2</td></tr>
<tr><td>Ryan Merritt*	0</td></tr>
<tr><td>Devin Mesoraco	0</td></tr>
<tr><td>Alex Meyer	0</td></tr>
<tr><td>Alex Meyer	0</td></tr>
<tr><td>Will Middlebrooks	0</td></tr>
<tr><td>Wade Miley*	0</td></tr>
<tr><td>Wade Miley*	0</td></tr>
<tr><td>Andrew Miller*	0</td></tr>
<tr><td>Andrew Miller*	0</td></tr>
<tr><td>Brad Miller*	30</td></tr>
<tr><td>Justin Miller	0</td></tr>
<tr><td>Mike Miller	0</td></tr>
<tr><td>Shelby Miller	0</td></tr>
<tr><td>Alec Mills	0</td></tr>
<tr><td>Tommy Milone*	0</td></tr>
<tr><td>Juan Minaya	0</td></tr>
<tr><td>Ariel Miranda*	0</td></tr>
<tr><td>Ariel Miranda*	0</td></tr>
<tr><td>Bryan Mitchell*	0</td></tr>
<tr><td>Yadier Molina	8</td></tr>
<tr><td>Dustin Molleken*	0</td></tr>
<tr><td>Yoan Moncada#	0</td></tr>
<tr><td>Raul Mondesi#	2</td></tr>
<tr><td>Miguel Montero*	8</td></tr>
<tr><td>Rafael Montero	0</td></tr>
<tr><td>Mike Montgomery*	0</td></tr>
<tr><td>Mike Montgomery*	0</td></tr>
<tr><td>Adam Moore	0</td></tr>
<tr><td>Matt Moore*	0</td></tr>
<tr><td>Matt Moore*	0</td></tr>
<tr><td>Franklin Morales*	0</td></tr>
<tr><td>Kendrys Morales#	30</td></tr>
<tr><td>Colin Moran*	0</td></tr>
<tr><td>Mitch Moreland*	22</td></tr>
<tr><td>Adam Morgan*	0</td></tr>
<tr><td>Shawn Morimando*	0</td></tr>
<tr><td>Mike Morin	0</td></tr>
<tr><td>Justin Morneau*	6</td></tr>
<tr><td>Max Moroff#	0</td></tr>
<tr><td>A.J. Morris	0</td></tr>
<tr><td>Bryan Morris*	0</td></tr>
<tr><td>Logan Morrison*	14</td></tr>
<tr><td>Brandon Morrow	0</td></tr>
<tr><td>Mike Morse	0</td></tr>
<tr><td>Charlie Morton	0</td></tr>
<tr><td>Jon Moscot	0</td></tr>
<tr><td>Brandon Moss*	28</td></tr>
<tr><td>Jason Motte	0</td></tr>
<tr><td>Taylor Motter	2</td></tr>
<tr><td>Mike Moustakas*	7</td></tr>
<tr><td>Steven Moya*	5</td></tr>
<tr><td>Peter Moylan	0</td></tr>
<tr><td>Conor Mullee	0</td></tr>
<tr><td>Max Muncy*	2</td></tr>
<tr><td>Daniel Murphy*	25</td></tr>
<tr><td>John Ryan Murphy	1</td></tr>
<tr><td>Tom Murphy	5</td></tr>
<tr><td>Colton Murray	0</td></tr>
<tr><td>Joseph Musgrove	0</td></tr>
<tr><td>Wil Myers	28</td></tr>
<tr><td>Mike Napoli	34</td></tr>
<tr><td>Tyler Naquin*	14</td></tr>
<tr><td>Omar Narvaez*	1</td></tr>
<tr><td>Chris Narveson*	0</td></tr>
<tr><td>Joe Nathan	0</td></tr>
<tr><td>Joe Nathan	0</td></tr>
<tr><td>Daniel Nava#	1</td></tr>
<tr><td>Daniel Nava#	0</td></tr>
<tr><td>Dioner Navarro#	6</td></tr>
<tr><td>Dioner Navarro#	0</td></tr>
<tr><td>Zach Neal	0</td></tr>
<tr><td>Jimmy Nelson	0</td></tr>
<tr><td>Hector Neris	0</td></tr>
<tr><td>Pat Neshek#	0</td></tr>
<tr><td>Juan Nicasio	0</td></tr>
<tr><td>Brett Nicholas*	2</td></tr>
<tr><td>Justin Nicolino*	0</td></tr>
<tr><td>Jon Niese*	0</td></tr>
<tr><td>Jon Niese*	0</td></tr>
<tr><td>Kirk Nieuwenhuis*	13</td></tr>
<tr><td>Brandon Nimmo*	1</td></tr>
<tr><td>Aaron Nola	0</td></tr>
<tr><td>Ricky Nolasco	0</td></tr>
<tr><td>Ricky Nolasco	0</td></tr>
<tr><td>Nick Noonan*	0</td></tr>
<tr><td>Bud Norris	0</td></tr>
<tr><td>Bud Norris	0</td></tr>
<tr><td>Daniel Norris*	0</td></tr>
<tr><td>Derek Norris	14</td></tr>
<tr><td>Ivan Nova	0</td></tr>
<tr><td>Ivan Nova	0</td></tr>
<tr><td>Eduardo Nunez	12</td></tr>
<tr><td>Eduardo Nunez	4</td></tr>
<tr><td>Renato Nunez	0</td></tr>
<tr><td>Vidal Nuno*	0</td></tr>
<tr><td>Peter O'Brien	5</td></tr>
<tr><td>Darren O'Day	0</td></tr>
<tr><td>Eric O'Flaherty*	0</td></tr>
<tr><td>Shawn O'Malley#	2</td></tr>
<tr><td>Ryan O'Rourke	0</td></tr>
<tr><td>Sean O'Sullivan	0</td></tr>
<tr><td>Scott Oberg	0</td></tr>
<tr><td>Brett Oberholtzer*	0</td></tr>
<tr><td>Brett Oberholtzer*	0</td></tr>
<tr><td>Rougned Odor*	33</td></tr>
<tr><td>Jake Odorizzi	0</td></tr>
<tr><td>Alexi Ogando	0</td></tr>
<tr><td>Nefi Ogando	0</td></tr>
<tr><td>Seung-hwan Oh	0</td></tr>
<tr><td>Ross Ohlendorf	0</td></tr>
<tr><td>Steven Okert*	0</td></tr>
<tr><td>Hector Olivera	0</td></tr>
<tr><td>Matt Olson*	0</td></tr>
<tr><td>Tyler Olson	0</td></tr>
<tr><td>Logan Ondrusek	0</td></tr>
<tr><td>Paulo Orlando	5</td></tr>
<tr><td>Rafael Ortega*	1</td></tr>
<tr><td>David Ortiz*	38</td></tr>
<tr><td>Josh Osich*	0</td></tr>
<tr><td>Roberto Osuna	0</td></tr>
<tr><td>Dan Otero	0</td></tr>
<tr><td>Adam Ottavino#	0</td></tr>
<tr><td>Dillon Overton*	0</td></tr>
<tr><td>Henry Owens*	0</td></tr>
<tr><td>Chris Owings	5</td></tr>
<tr><td>Marcell Ozuna	23</td></tr>
<tr><td>Jordan Pacheco	0</td></tr>
<tr><td>Angel Pagan#	12</td></tr>
<tr><td>Joe Panik*	10</td></tr>
<tr><td>Jonathan Papelbon	0</td></tr>
<tr><td>Jimmy Paredes#	1</td></tr>
<tr><td>Jimmy Paredes#	4</td></tr>
<tr><td>Byung Ho Park	12</td></tr>
<tr><td>Blake Parker	0</td></tr>
<tr><td>Blake Parker	0</td></tr>
<tr><td>Jarrett Parker*	5</td></tr>
<tr><td>Chris Parmelee*	2</td></tr>
<tr><td>Bobby Parnell	0</td></tr>
<tr><td>Gerardo Parra*	7</td></tr>
<tr><td>Curtis Partch	0</td></tr>
<tr><td>Jordan Patterson*	0</td></tr>
<tr><td>Spencer Patton	0</td></tr>
<tr><td>David Paulino	0</td></tr>
<tr><td>Ben Paulsen*	1</td></tr>
<tr><td>James Paxton*	0</td></tr>
<tr><td>James Pazos	0</td></tr>
<tr><td>Brad Peacock	0</td></tr>
<tr><td>Steve Pearce	10</td></tr>
<tr><td>Steve Pearce	3</td></tr>
<tr><td>Jake Peavy	0</td></tr>
<tr><td>Joc Pederson*	25</td></tr>
<tr><td>Dustin Pedroia	15</td></tr>
<tr><td>Mike Pelfrey	0</td></tr>
<tr><td>Ariel Pena	0</td></tr>
<tr><td>Brayan Pena#	0</td></tr>
<tr><td>Felix Pena	0</td></tr>
<tr><td>Francisco Pena	1</td></tr>
<tr><td>Ramiro Pena#	1</td></tr>
<tr><td>Hunter Pence	13</td></tr>
<tr><td>Cliff Pennington#	3</td></tr>
<tr><td>David Peralta*	4</td></tr>
<tr><td>Jhonny Peralta	8</td></tr>
<tr><td>Joel Peralta	0</td></tr>
<tr><td>Joel Peralta	0</td></tr>
<tr><td>Wandy Peralta*	0</td></tr>
<tr><td>Wily Peralta	1</td></tr>
<tr><td>Jose Peraza	3</td></tr>
<tr><td>Luis Perdomo	0</td></tr>
<tr><td>Carlos Perez	5</td></tr>
<tr><td>Hernan Perez	13</td></tr>
<tr><td>Martin Perez*	0</td></tr>
<tr><td>Oliver Perez*	0</td></tr>
<tr><td>Roberto Perez	3</td></tr>
<tr><td>Salvador Perez	22</td></tr>
<tr><td>Williams Perez	0</td></tr>
<tr><td>Yefri Perez#	0</td></tr>
<tr><td>Glen Perkins*	0</td></tr>
<tr><td>Jace Peterson*	7</td></tr>
<tr><td>Gregorio Petit	2</td></tr>
<tr><td>Yusmeiro Petit	0</td></tr>
<tr><td>Jake Petricka	0</td></tr>
<tr><td>Tommy Pham	9</td></tr>
<tr><td>Josh Phegley	1</td></tr>
<tr><td>David Phelps	0</td></tr>
<tr><td>Brandon Phillips	11</td></tr>
<tr><td>Zach Phillips*	0</td></tr>
<tr><td>A.J. Pierzynski*	2</td></tr>
<tr><td>Kevin Pillar	7</td></tr>
<tr><td>Manny Pina	2</td></tr>
<tr><td>Branden Pinder	0</td></tr>
<tr><td>Chad Pinder	1</td></tr>
<tr><td>Michael Pineda	0</td></tr>
<tr><td>Josmil Pinto	0</td></tr>
<tr><td>Jose Pirela	0</td></tr>
<tr><td>Stephen Piscotty	22</td></tr>
<tr><td>Kevin Plawecki	1</td></tr>
<tr><td>Trevor Plouffe	12</td></tr>
<tr><td>Adam Plutko	0</td></tr>
<tr><td>Gregory Polanco*	22</td></tr>
<tr><td>Jorge Polanco#	4</td></tr>
<tr><td>A.J. Pollock	2</td></tr>
<tr><td>Drew Pomeranz	1</td></tr>
<tr><td>Drew Pomeranz	0</td></tr>
<tr><td>Dalton Pompey#	0</td></tr>
<tr><td>Rick Porcello	0</td></tr>
<tr><td>Buster Posey	14</td></tr>
<tr><td>Brooks Pounders	0</td></tr>
<tr><td>Martin Prado	8</td></tr>
<tr><td>Alex Presley*	3</td></tr>
<tr><td>Alex Presley*	0</td></tr>
<tr><td>Ryan Pressly	0</td></tr>
<tr><td>David Price*	0</td></tr>
<tr><td>Jurickson Profar#	5</td></tr>
<tr><td>Yasiel Puig	11</td></tr>
<tr><td>Albert Pujols	31</td></tr>
<tr><td>Matt Purke*	0</td></tr>
<tr><td>Zach Putnam	0</td></tr>
<tr><td>Kevin Quackenbush	0</td></tr>
<tr><td>Chad Qualls	0</td></tr>
<tr><td>Juniel Querecuto#	0</td></tr>
<tr><td>Roman Quinn#	0</td></tr>
<tr><td>Jose Quintana	0</td></tr>
<tr><td>Ryan Raburn	9</td></tr>
<tr><td>Alexei Ramirez	5</td></tr>
<tr><td>Alexei Ramirez	1</td></tr>
<tr><td>Erasmo Ramirez	0</td></tr>
<tr><td>Hanley Ramirez	30</td></tr>
<tr><td>J.C. Ramirez	0</td></tr>
<tr><td>J.C. Ramirez	0</td></tr>
<tr><td>Jose Ramirez	0</td></tr>
<tr><td>Jose Ramirez#	11</td></tr>
<tr><td>Neil Ramirez	0</td></tr>
<tr><td>Neil Ramirez	0</td></tr>
<tr><td>Neil Ramirez	0</td></tr>
<tr><td>Noe Ramirez	0</td></tr>
<tr><td>A.J. Ramos	0</td></tr>
<tr><td>Cesar Ramos*	0</td></tr>
<tr><td>Edubray Ramos	0</td></tr>
<tr><td>Wilson Ramos	22</td></tr>
<tr><td>Anthony Ranaudo	0</td></tr>
<tr><td>Anthony Ranaudo	1</td></tr>
<tr><td>Colby Rasmus*	15</td></tr>
<tr><td>Cory Rasmus	0</td></tr>
<tr><td>Josh Ravin	0</td></tr>
<tr><td>Robbie Ray*	1</td></tr>
<tr><td>Colin Rea	0</td></tr>
<tr><td>Colin Rea	0</td></tr>
<tr><td>J.T. Realmuto	11</td></tr>
<tr><td>Anthony Recker	2</td></tr>
<tr><td>Josh Reddick*	8</td></tr>
<tr><td>Josh Reddick*	2</td></tr>
<tr><td>A.J. Reed*	3</td></tr>
<tr><td>Addison Reed*	0</td></tr>
<tr><td>Cody Reed*	0</td></tr>
<tr><td>Michael Reed	0</td></tr>
<tr><td>Rob Refsnyder	0</td></tr>
<tr><td>Nolan Reimold	6</td></tr>
<tr><td>Tony Renda	0</td></tr>
<tr><td>Anthony Rendon	20</td></tr>
<tr><td>Hunter Renfroe	4</td></tr>
<tr><td>Ben Revere*	2</td></tr>
<tr><td>Alex Reyes	0</td></tr>
<tr><td>Jo-Jo Reyes*	0</td></tr>
<tr><td>Jose Reyes#	8</td></tr>
<tr><td>Mark Reynolds	14</td></tr>
<tr><td>Matt Reynolds*	0</td></tr>
<tr><td>Matt Reynolds	3</td></tr>
<tr><td>Clayton Richard*	0</td></tr>
<tr><td>Clayton Richard*	0</td></tr>
<tr><td>Garrett Richards	0</td></tr>
<tr><td>Joey Rickard	5</td></tr>
<tr><td>Rene Rivera	6</td></tr>
<tr><td>T.J. Rivera	3</td></tr>
<tr><td>Yadiel Rivera	0</td></tr>
<tr><td>Felipe Rivero*	0</td></tr>
<tr><td>Felipe Rivero*	0</td></tr>
<tr><td>Anthony Rizzo*	32</td></tr>
<tr><td>Donn Roach	0</td></tr>
<tr><td>Tanner Roark	0</td></tr>
<tr><td>Dan Robertson	0</td></tr>
<tr><td>David Robertson	0</td></tr>
<tr><td>Clint Robinson*	5</td></tr>
<tr><td>Shane Robinson	1</td></tr>
<tr><td>Hansel Robles	0</td></tr>
<tr><td>Brady Rodgers	0</td></tr>
<tr><td>Fernando Rodney	0</td></tr>
<tr><td>Fernando Rodney	0</td></tr>
<tr><td>Carlos Rodon*	0</td></tr>
<tr><td>Alex Rodriguez	9</td></tr>
<tr><td>Eduardo Rodriguez*	0</td></tr>
<tr><td>Fernando Rodriguez	0</td></tr>
<tr><td>Francisco Rodriguez	0</td></tr>
<tr><td>Joely Rodriguez*	0</td></tr>
<tr><td>Sean Rodriguez	18</td></tr>
<tr><td>Chaz Roe	0</td></tr>
<tr><td>Chaz Roe	0</td></tr>
<tr><td>Jason Rogers	0</td></tr>
<tr><td>Taylor Rogers*	0</td></tr>
<tr><td>Miguel Rojas	1</td></tr>
<tr><td>David Rollins*	0</td></tr>
<tr><td>Jimmy Rollins#	2</td></tr>
<tr><td>Enny Romero*	0</td></tr>
<tr><td>Stefen Romero	0</td></tr>
<tr><td>Andrew Romine#	2</td></tr>
<tr><td>Austin Romine	4</td></tr>
<tr><td>Sergio Romo	0</td></tr>
<tr><td>Bruce Rondon	0</td></tr>
<tr><td>Hector Rondon	0</td></tr>
<tr><td>Jorge Rondon	0</td></tr>
<tr><td>Jose Rondon	0</td></tr>
<tr><td>Adam Rosales	13</td></tr>
<tr><td>Alberto Rosario	0</td></tr>
<tr><td>Eddie Rosario*	10</td></tr>
<tr><td>Trevor Rosenthal	0</td></tr>
<tr><td>David Ross	10</td></tr>
<tr><td>Joe Ross	0</td></tr>
<tr><td>Robbie Ross*	0</td></tr>
<tr><td>Tyson Ross	0</td></tr>
<tr><td>Michael Roth*	0</td></tr>
<tr><td>Ben Rowen	0</td></tr>
<tr><td>Ryan Rua	8</td></tr>
<tr><td>Darin Ruf	3</td></tr>
<tr><td>Justin Ruggiano	0</td></tr>
<tr><td>Justin Ruggiano	2</td></tr>
<tr><td>Carlos Ruiz	3</td></tr>
<tr><td>Carlos Ruiz	0</td></tr>
<tr><td>Rio Ruiz*	0</td></tr>
<tr><td>Cameron Rupp	16</td></tr>
<tr><td>Chris Rusin*	0</td></tr>
<tr><td>Addison Russell	21</td></tr>
<tr><td>James Russell*	0</td></tr>
<tr><td>Josh Rutledge	0</td></tr>
<tr><td>Brendan Ryan	0</td></tr>
<tr><td>Kyle Ryan*	0</td></tr>
<tr><td>Hyun-Jin Ryu	0</td></tr>
<tr><td>Marc Rzepczynski*	0</td></tr>
<tr><td>Marc Rzepczynski*	0</td></tr>
<tr><td>CC Sabathia*	0</td></tr>
<tr><td>Tyler Saladino	8</td></tr>
<tr><td>Fernando Salas	0</td></tr>
<tr><td>Fernando Salas	0</td></tr>
<tr><td>Danny Salazar*	0</td></tr>
<tr><td>Chris Sale*	0</td></tr>
<tr><td>Jarrod Saltalamacchia#	12</td></tr>
<tr><td>Jeff Samardzija	0</td></tr>
<tr><td>Adrian Sampson	0</td></tr>
<tr><td>Keyvius Sampson	0</td></tr>
<tr><td>Aaron Sanchez	0</td></tr>
<tr><td>Anibal Sanchez	0</td></tr>
<tr><td>Carlos Sanchez#	4</td></tr>
<tr><td>Gary Sanchez	20</td></tr>
<tr><td>Hector Sanchez#	0</td></tr>
<tr><td>Hector Sanchez#	3</td></tr>
<tr><td>Pablo Sandoval#	0</td></tr>
<tr><td>Jerry Sands	1</td></tr>
<tr><td>Miguel Sano	25</td></tr>
<tr><td>Carlos Santana#	34</td></tr>
<tr><td>Danny Santana#	2</td></tr>
<tr><td>Domingo Santana	11</td></tr>
<tr><td>Ervin Santana	0</td></tr>
<tr><td>Hector Santiago	0</td></tr>
<tr><td>Hector Santiago	0</td></tr>
<tr><td>Luis Sardinas#	2</td></tr>
<tr><td>Luis Sardinas#	2</td></tr>
<tr><td>Michael Saunders*	24</td></tr>
<tr><td>Warwick Saupold	0</td></tr>
<tr><td>Rob Scahill*	0</td></tr>
<tr><td>Rob Scahill*	0</td></tr>
<tr><td>Logan Schafer*	0</td></tr>
<tr><td>Scott Schebler*	9</td></tr>
<tr><td>Tanner Scheppers	0</td></tr>
<tr><td>Max Scherzer	0</td></tr>
<tr><td>Ryan Schimpf*	20</td></tr>
<tr><td>Jonathan Schoop	25</td></tr>
<tr><td>A.J. Schugel	0</td></tr>
<tr><td>Bo Schultz	0</td></tr>
<tr><td>Patrick Schuster	0</td></tr>
<tr><td>Patrick Schuster	0</td></tr>
<tr><td>Kyle Schwarber*	0</td></tr>
<tr><td>Robby Scott#	0</td></tr>
<tr><td>Evan Scribner	0</td></tr>
<tr><td>Xavier Scruggs	1</td></tr>
<tr><td>Corey Seager*	26</td></tr>
<tr><td>Kyle Seager*	30</td></tr>
<tr><td>Rob Segedin	2</td></tr>
<tr><td>Jean Segura	20</td></tr>
<tr><td>Steve Selsky	2</td></tr>
<tr><td>Marcus Semien	27</td></tr>
<tr><td>Luis Severino	0</td></tr>
<tr><td>Pedro Severino	2</td></tr>
<tr><td>Richie Shaffer	1</td></tr>
<tr><td>Bryan Shaw#	0</td></tr>
<tr><td>Travis Shaw*	16</td></tr>
<tr><td>James Shields	0</td></tr>
<tr><td>James Shields	0</td></tr>
<tr><td>Braden Shipley	0</td></tr>
<tr><td>Matt Shoemaker	0</td></tr>
<tr><td>Chasen Shreve*	0</td></tr>
<tr><td>J.B. Shuck*	4</td></tr>
<tr><td>Kevin Siegrist*	0</td></tr>
<tr><td>Andrelton Simmons	4</td></tr>
<tr><td>Shae Simmons	0</td></tr>
<tr><td>Alfredo Simon	0</td></tr>
<tr><td>Tony Sipp*	0</td></tr>
<tr><td>Tyler Skaggs*	0</td></tr>
<tr><td>Blake Smith*	0</td></tr>
<tr><td>Carson Smith	0</td></tr>
<tr><td>Chris Smith	0</td></tr>
<tr><td>Jake Smith	0</td></tr>
<tr><td>Joe Smith	0</td></tr>
<tr><td>Joe Smith	0</td></tr>
<tr><td>Josh Smith	0</td></tr>
<tr><td>Kevan Smith	0</td></tr>
<tr><td>Mallex Smith*	3</td></tr>
<tr><td>Seth Smith*	16</td></tr>
<tr><td>Will Smith	0</td></tr>
<tr><td>Will Smith	0</td></tr>
<tr><td>Justin Smoak#	14</td></tr>
<tr><td>Josh Smoker*	0</td></tr>
<tr><td>Jake Smolinski	7</td></tr>
<tr><td>Drew Smyly*	0</td></tr>
<tr><td>Blake Snell*	0</td></tr>
<tr><td>Brandon Snyder	4</td></tr>
<tr><td>Miguel Socolovich	0</td></tr>
<tr><td>Donovan Solano	1</td></tr>
<tr><td>Yangervis Solarte#	15</td></tr>
<tr><td>Jorge Soler	12</td></tr>
<tr><td>Sammy Solis	0</td></tr>
<tr><td>Layne Somsen	0</td></tr>
<tr><td>Joakim Soria	0</td></tr>
<tr><td>Geovany Soto	4</td></tr>
<tr><td>Steven Souza	17</td></tr>
<tr><td>Denard Span*	11</td></tr>
<tr><td>Cory Spangenberg*	1</td></tr>
<tr><td>George Springer	29</td></tr>
<tr><td>Jacob Stallings	0</td></tr>
<tr><td>Giancarlo Stanton	27</td></tr>
<tr><td>Max Stassi	0</td></tr>
<tr><td>Robert Stephenson	0</td></tr>
<tr><td>Brock Stewart*	0</td></tr>
<tr><td>Chris Stewart	1</td></tr>
<tr><td>Drew Storen#	0</td></tr>
<tr><td>Drew Storen#	0</td></tr>
<tr><td>Trevor Story	27</td></tr>
<tr><td>Matt Strahm	0</td></tr>
<tr><td>Dan Straily	0</td></tr>
<tr><td>Stephen Strasburg	0</td></tr>
<tr><td>Chris Stratton	0</td></tr>
<tr><td>Huston Street	0</td></tr>
<tr><td>Hunter Strickland	0</td></tr>
<tr><td>Ross Stripling	0</td></tr>
<tr><td>Marcus Stroman	0</td></tr>
<tr><td>Pedro Strop	0</td></tr>
<tr><td>Drew Stubbs	1</td></tr>
<tr><td>Drew Stubbs	2</td></tr>
<tr><td>Drew Stubbs	0</td></tr>
<tr><td>Daniel Stumpf*	0</td></tr>
<tr><td>Tyler Sturdevant	0</td></tr>
<tr><td>Albert Suarez	0</td></tr>
<tr><td>Eugenio Suarez	21</td></tr>
<tr><td>Jesus Sucre	1</td></tr>
<tr><td>Eric Surkamp*	0</td></tr>
<tr><td>Andrew Susac	1</td></tr>
<tr><td>Brent Suter*	0</td></tr>
<tr><td>Ichiro Suzuki*	1</td></tr>
<tr><td>Kurt Suzuki	8</td></tr>
<tr><td>Dansby Swanson	3</td></tr>
<tr><td>Anthony Swarzak	0</td></tr>
<tr><td>Blake Swihart#	0</td></tr>
<tr><td>Noah Syndergaard*	3</td></tr>
<tr><td>Matt Szczur	5</td></tr>
<tr><td>Jameson Taillon	0</td></tr>
<tr><td>Masahiro Tanaka	0</td></tr>
<tr><td>Raimel Tapia*	0</td></tr>
<tr><td>Chris Taylor	0</td></tr>
<tr><td>Chris Taylor	1</td></tr>
<tr><td>Michael Taylor	7</td></tr>
<tr><td>Junichi Tazawa	0</td></tr>
<tr><td>Julio Teheran	0</td></tr>
<tr><td>Mark Teixeira#	15</td></tr>
<tr><td>Ruben Tejada	0</td></tr>
<tr><td>Ruben Tejada	0</td></tr>
<tr><td>Tomas Telis#	1</td></tr>
<tr><td>Ryan Tepera	0</td></tr>
<tr><td>Nick Tepesch	0</td></tr>
<tr><td>Josh Thole*	1</td></tr>
<tr><td>Jake Thompson	0</td></tr>
<tr><td>Trayce Thompson	13</td></tr>
<tr><td>Tyler Thornburg	0</td></tr>
<tr><td>Matt Thornton*	0</td></tr>
<tr><td>Chris Tillman	0</td></tr>
<tr><td>Charlie Tilson*	0</td></tr>
<tr><td>Andrew Toles*	3</td></tr>
<tr><td>Shawn Tolleson	0</td></tr>
<tr><td>Ashur Tolliver*	0</td></tr>
<tr><td>Yasmany Tomas	31</td></tr>
<tr><td>Josh Tomlin	0</td></tr>
<tr><td>Kelby Tomlinson	0</td></tr>
<tr><td>Michael Tonkin	0</td></tr>
<tr><td>Carlos Torres	0</td></tr>
<tr><td>Jose Torres*	0</td></tr>
<tr><td>Ronald Torreyes	1</td></tr>
<tr><td>Devon Travis	11</td></tr>
<tr><td>Blake Treinen	0</td></tr>
<tr><td>Andrew Triggs	0</td></tr>
<tr><td>Nick Tropeano	0</td></tr>
<tr><td>Mike Trout	29</td></tr>
<tr><td>Mark Trumbo	47</td></tr>
<tr><td>Chin-hui Tsao	0</td></tr>
<tr><td>Preston Tucker*	4</td></tr>
<tr><td>Matt Tuiasosopo	0</td></tr>
<tr><td>Sam Tuivailala	0</td></tr>
<tr><td>Troy Tulowitzki	24</td></tr>
<tr><td>Jacob Turner	0</td></tr>
<tr><td>Justin Turner	27</td></tr>
<tr><td>Trea Turner	13</td></tr>
<tr><td>Koji Uehara	0</td></tr>
<tr><td>Justin Upton	31</td></tr>
<tr><td>Melvin Upton	16</td></tr>
<tr><td>Melvin Upton	4</td></tr>
<tr><td>Jose Urena	0</td></tr>
<tr><td>Julio Urias*	0</td></tr>
<tr><td>Juan Uribe	7</td></tr>
<tr><td>Chase Utley*	14</td></tr>
<tr><td>Pat Valaika	1</td></tr>
<tr><td>Luis Valbuena*	13</td></tr>
<tr><td>Jose Valdez	0</td></tr>
<tr><td>Danny Valencia	17</td></tr>
<tr><td>Scott Van Slyke	1</td></tr>
<tr><td>Cesar Vargas	0</td></tr>
<tr><td>Jason Vargas*	0</td></tr>
<tr><td>Kennys Vargas#	10</td></tr>
<tr><td>Christian Vazquez	1</td></tr>
<tr><td>Vince Velasquez	0</td></tr>
<tr><td>Will Venable*	0</td></tr>
<tr><td>Pat Venditte*	0</td></tr>
<tr><td>Pat Venditte*	0</td></tr>
<tr><td>Yordano Ventura	0</td></tr>
<tr><td>Drew VerHagen	0</td></tr>
<tr><td>Justin Verlander	0</td></tr>
<tr><td>Logan Verrett	0</td></tr>
<tr><td>Carlos Villanueva	0</td></tr>
<tr><td>Jonathan Villar#	19</td></tr>
<tr><td>Nick Vincent	0</td></tr>
<tr><td>Arodys Vizcaino	0</td></tr>
<tr><td>Dan Vogelbach*	0</td></tr>
<tr><td>Ryan Vogelsong	0</td></tr>
<tr><td>Stephen Vogt*	14</td></tr>
<tr><td>Edinson Volquez	0</td></tr>
<tr><td>Joey Votto*	29</td></tr>
<tr><td>Michael Wacha	0</td></tr>
<tr><td>Tyler Wagner	0</td></tr>
<tr><td>Adam Wainwright	2</td></tr>
<tr><td>Kyle Waldrop*	0</td></tr>
<tr><td>Neil Walker#	23</td></tr>
<tr><td>Taijuan Walker	0</td></tr>
<tr><td>Brett Wallace*	6</td></tr>
<tr><td>Colin Walsh#	0</td></tr>
<tr><td>Zach Walters#	0</td></tr>
<tr><td>Chien-Ming Wang	0</td></tr>
<tr><td>Adam Warren	0</td></tr>
<tr><td>Adam Warren	0</td></tr>
<tr><td>Tony Watson*	0</td></tr>
<tr><td>Jered Weaver	0</td></tr>
<tr><td>Luke Weaver	0</td></tr>
<tr><td>Daniel Webb	0</td></tr>
<tr><td>Ryan Webb	0</td></tr>
<tr><td>Ryan Weber	0</td></tr>
<tr><td>Jemile Weeks#	0</td></tr>
<tr><td>Rickie Weeks	9</td></tr>
<tr><td>J.B. Wendelken	0</td></tr>
<tr><td>Joey Wendle*	1</td></tr>
<tr><td>Jayson Werth	21</td></tr>
<tr><td>Robert Whalen	0</td></tr>
<tr><td>Tyler White	8</td></tr>
<tr><td>Chase Whitley	0</td></tr>
<tr><td>Joe Wieland	0</td></tr>
<tr><td>Matt Wieters#	17</td></tr>
<tr><td>Tom Wilhelmsen	0</td></tr>
<tr><td>Tom Wilhelmsen	0</td></tr>
<tr><td>Andy Wilkins*	1</td></tr>
<tr><td>Jerome Williams	0</td></tr>
<tr><td>Mason Williams*	0</td></tr>
<tr><td>Trevor Williams	0</td></tr>
<tr><td>Mac Williamson	6</td></tr>
<tr><td>Alex Wilson	0</td></tr>
<tr><td>Bobby Wilson	0</td></tr>
<tr><td>Bobby Wilson	3</td></tr>
<tr><td>Bobby Wilson	4</td></tr>
<tr><td>Justin Wilson*	0</td></tr>
<tr><td>Tyler Wilson	0</td></tr>
<tr><td>Alex Wimmers*	0</td></tr>
<tr><td>Daniel Winkler	0</td></tr>
<tr><td>Matt Wisler	0</td></tr>
<tr><td>Chris Withrow	0</td></tr>
<tr><td>Nick Wittgren	0</td></tr>
<tr><td>Tony Wolters*	3</td></tr>
<tr><td>Kolten Wong*	5</td></tr>
<tr><td>Alex Wood	0</td></tr>
<tr><td>Blake Wood	0</td></tr>
<tr><td>Travis Wood	0</td></tr>
<tr><td>Vance Worley	0</td></tr>
<tr><td>Danny Worth	0</td></tr>
<tr><td>Daniel Wright	0</td></tr>
<tr><td>Daniel Wright	0</td></tr>
<tr><td>David Wright	7</td></tr>
<tr><td>Mike Wright	0</td></tr>
<tr><td>Steven Wright	0</td></tr>
<tr><td>Kirby Yates*	0</td></tr>
<tr><td>Christian Yelich*	21</td></tr>
<tr><td>Gabriel Ynoa	0</td></tr>
<tr><td>Michael Ynoa	0</td></tr>
<tr><td>Rafael Ynoa#	0</td></tr>
<tr><td>Chris Young	9</td></tr>
<tr><td>Chris Young	0</td></tr>
<tr><td>Eric Young#	0</td></tr>
<tr><td>Madison Younginer	0</td></tr>
<tr><td>Rob Zastryzny	0</td></tr>
<tr><td>Brad Ziegler	0</td></tr>
<tr><td>Brad Ziegler	0</td></tr>
<tr><td>Ryan Zimmerman	15</td></tr>
<tr><td>Jordan Zimmermann	0</td></tr>
<tr><td>Ben Zobrist#	18</td></tr>
<tr><td>Mike Zunino	12</td></tr>
<tr><td>Tony Zych	0</td></tr>
</table>
</body>
</html>
