<html>
<body>
<table>
<tr><td>Fernando Abad*	0</td></tr>
<tr><td>Fernando Abad*	0</td></tr>
<tr><td>Jose Abreu	100</td></tr>
<tr><td>A.J. Achter	0</td></tr>
<tr><td>Dustin Ackley*	4</td></tr>
<tr><td>Cristhian Adames#	17</td></tr>
<tr><td>Austin Adams	0</td></tr>
<tr><td>Matt Adams*	54</td></tr>
<tr><td>Tim Adleman	3</td></tr>
<tr><td>Ehire Adrianza#	7</td></tr>
<tr><td>Jesus Aguilar	0</td></tr>
<tr><td>Nick Ahmed	20</td></tr>
<tr><td>Andrew Albers	0</td></tr>
<tr><td>Matt Albers*	0</td></tr>
<tr><td>Hanser Alberto	5</td></tr>
<tr><td>Al Alburquerque	0</td></tr>
<tr><td>Arismendy Alcantara#	2</td></tr>
<tr><td>Raul Alcantara	0</td></tr>
<tr><td>Scott Alexander*	0</td></tr>
<tr><td>Jorge Alfaro	0</td></tr>
<tr><td>Cody Allen	0</td></tr>
<tr><td>Abraham Almonte#	22</td></tr>
<tr><td>Albert Almora	14</td></tr>
<tr><td>Yonder Alonso*	56</td></tr>
<tr><td>Dan Altavilla	0</td></tr>
<tr><td>Aaron Altherr	22</td></tr>
<tr><td>Jose Altuve	96</td></tr>
<tr><td>Dariel Alvarez	0</td></tr>
<tr><td>Dario Alvarez*	0</td></tr>
<tr><td>Dario Alvarez*	0</td></tr>
<tr><td>Jose Alvarez*	0</td></tr>
<tr><td>Pedro Alvarez*	49</td></tr>
<tr><td>Alexi Amarista*	11</td></tr>
<tr><td>Brett Anderson*	0</td></tr>
<tr><td>Chase Anderson	1</td></tr>
<tr><td>Cody Anderson	0</td></tr>
<tr><td>Tim Anderson	30</td></tr>
<tr><td>Tyler Anderson*	3</td></tr>
<tr><td>Robert Andino	1</td></tr>
<tr><td>Matt Andriese	0</td></tr>
<tr><td>Elvis Andrus	69</td></tr>
<tr><td>Dustin Antolin	0</td></tr>
<tr><td>Nori Aoki*	28</td></tr>
<tr><td>Jayson Aquino*	0</td></tr>
<tr><td>Elvis Araujo*	0</td></tr>
<tr><td>Chris Archer	0</td></tr>
<tr><td>Orlando Arcia	17</td></tr>
<tr><td>Oswaldo Arcia*	12</td></tr>
<tr><td>Oswaldo Arcia*	7</td></tr>
<tr><td>Oswaldo Arcia*	0</td></tr>
<tr><td>Oswaldo Arcia*	4</td></tr>
<tr><td>Nolan Arenado	133</td></tr>
<tr><td>Shawn Armstrong	0</td></tr>
<tr><td>Jonathan Aro	0</td></tr>
<tr><td>Jake Arrieta	7</td></tr>
<tr><td>Cody Asche*	18</td></tr>
<tr><td>Alec Asher	2</td></tr>
<tr><td>Carlos Asuaje*	2</td></tr>
<tr><td>Tyler Austin	12</td></tr>
<tr><td>Alex Avila*	11</td></tr>
<tr><td>Luis Avilan*	0</td></tr>
<tr><td>Mike Aviles	6</td></tr>
<tr><td>John Axford	0</td></tr>
<tr><td>Erick Aybar#	26</td></tr>
<tr><td>Erick Aybar#	8</td></tr>
<tr><td>Javier Baez	59</td></tr>
<tr><td>Pedro Baez	0</td></tr>
<tr><td>Andrew Bailey	0</td></tr>
<tr><td>Andrew Bailey	0</td></tr>
<tr><td>Homer Bailey	0</td></tr>
<tr><td>Jett Bandy	25</td></tr>
<tr><td>Johnny Barbato	0</td></tr>
<tr><td>Austin Barnes	2</td></tr>
<tr><td>Brandon Barnes	8</td></tr>
<tr><td>Danny Barnes*	0</td></tr>
<tr><td>Jacob Barnes	0</td></tr>
<tr><td>Matt Barnes	0</td></tr>
<tr><td>Tony Barnette	0</td></tr>
<tr><td>Darwin Barney	19</td></tr>
<tr><td>Tucker Barnhart#	51</td></tr>
<tr><td>Kyle Barraclough	0</td></tr>
<tr><td>Jake Barrett	0</td></tr>
<tr><td>Chris Bassitt	0</td></tr>
<tr><td>Antonio Bastardo	0</td></tr>
<tr><td>Antonio Bastardo	0</td></tr>
<tr><td>Trevor Bauer	0</td></tr>
<tr><td>Buddy Baumann*	0</td></tr>
<tr><td>Jose Bautista	69</td></tr>
<tr><td>Chris Beck	0</td></tr>
<tr><td>Gordon Beckham	30</td></tr>
<tr><td>Gordon Beckham	1</td></tr>
<tr><td>Tim Beckham	16</td></tr>
<tr><td>Cam Bedrosian	0</td></tr>
<tr><td>Matt Belisle	0</td></tr>
<tr><td>Josh Bell#	19</td></tr>
<tr><td>Brandon Belt*	82</td></tr>
<tr><td>Carlos Beltran#	64</td></tr>
<tr><td>Carlos Beltran#	29</td></tr>
<tr><td>Adrian Beltre	104</td></tr>
<tr><td>Andrew Benintendi*	14</td></tr>
<tr><td>Joaquin Benoit	0</td></tr>
<tr><td>Joaquin Benoit	0</td></tr>
<tr><td>James Beresford*	0</td></tr>
<tr><td>Christian Bergman	0</td></tr>
<tr><td>Jose Berrios	0</td></tr>
<tr><td>Dellin Betances	0</td></tr>
<tr><td>Christian Bethancourt	25</td></tr>
<tr><td>Chad Bettis	2</td></tr>
<tr><td>Mookie Betts	113</td></tr>
<tr><td>Joe Biagini	0</td></tr>
<tr><td>Ty Blach	0</td></tr>
<tr><td>Charlie Blackmon*	82</td></tr>
<tr><td>Aaron Blair	0</td></tr>
<tr><td>Andres Blanco#	21</td></tr>
<tr><td>Gregor Blanco*	18</td></tr>
<tr><td>Joe Blanton	0</td></tr>
<tr><td>Jabari Blash	5</td></tr>
<tr><td>Michael Blazek	0</td></tr>
<tr><td>Richard Bleier*	0</td></tr>
<tr><td>Jerry Blevins*	0</td></tr>
<tr><td>Xander Bogaerts	89</td></tr>
<tr><td>Mike Bolsinger	0</td></tr>
<tr><td>Emilio Bonifacio#	3</td></tr>
<tr><td>Julio Borbon*	0</td></tr>
<tr><td>Wilfredo Boscan	1</td></tr>
<tr><td>Buddy Boshers*	0</td></tr>
<tr><td>Justin Bour*	51</td></tr>
<tr><td>Peter Bourjos	23</td></tr>
<tr><td>Michael Bourn*	30</td></tr>
<tr><td>Michael Bourn*	8</td></tr>
<tr><td>Matthew Bowman	0</td></tr>
<tr><td>Brad Boxberger	0</td></tr>
<tr><td>Matt Boyd*	0</td></tr>
<tr><td>Blaine Boyer	0</td></tr>
<tr><td>Brad Brach	0</td></tr>
<tr><td>Silvino Bracho	0</td></tr>
<tr><td>Archie Bradley	4</td></tr>
<tr><td>Jackie Bradley*	87</td></tr>
<tr><td>Jed Bradley*	0</td></tr>
<tr><td>Michael Brantley*	7</td></tr>
<tr><td>Steven Brault*	0</td></tr>
<tr><td>Ryan Braun	91</td></tr>
<tr><td>Alex Bregman	34</td></tr>
<tr><td>Bryce Brentz	7</td></tr>
<tr><td>Craig Breslow*	0</td></tr>
<tr><td>Austin Brice	0</td></tr>
<tr><td>Parker Bridwell	0</td></tr>
<tr><td>Reid Brignac*	1</td></tr>
<tr><td>Socrates Brito*	12</td></tr>
<tr><td>Zach Britton*	0</td></tr>
<tr><td>Mike Broadway	0</td></tr>
<tr><td>Trevor Brown	19</td></tr>
<tr><td>Jonathan Broxton	0</td></tr>
<tr><td>Keon Broxton	19</td></tr>
<tr><td>Jay Bruce*	80</td></tr>
<tr><td>Jay Bruce*	19</td></tr>
<tr><td>Kris Bryant	102</td></tr>
<tr><td>Jake Buchanan	0</td></tr>
<tr><td>Clay Buchholz*	0</td></tr>
<tr><td>Ryan Buchter*	0</td></tr>
<tr><td>Madison Bumgarner	9</td></tr>
<tr><td>Dylan Bundy#	0</td></tr>
<tr><td>Enrique Burgos	0</td></tr>
<tr><td>Sean Burnett*	0</td></tr>
<tr><td>Andy Burns	0</td></tr>
<tr><td>Billy Burns#	12</td></tr>
<tr><td>Billy Burns#	1</td></tr>
<tr><td>Emmanuel Burriss#	0</td></tr>
<tr><td>Matt Buschmann	0</td></tr>
<tr><td>Matt Bush	0</td></tr>
<tr><td>Nick Buss*	8</td></tr>
<tr><td>Drew Butera	16</td></tr>
<tr><td>Billy Butler	31</td></tr>
<tr><td>Billy Butler	4</td></tr>
<tr><td>Eddie Butler	0</td></tr>
<tr><td>Byron Buxton	38</td></tr>
<tr><td>Marlon Byrd	19</td></tr>
<tr><td>Asdrubal Cabrera#	62</td></tr>
<tr><td>Mauricio Cabrera	0</td></tr>
<tr><td>Melky Cabrera#	86</td></tr>
<tr><td>Miguel Cabrera	108</td></tr>
<tr><td>Ramon Cabrera#	23</td></tr>
<tr><td>Trevor Cahill	1</td></tr>
<tr><td>Lorenzo Cain	56</td></tr>
<tr><td>Matt Cain	5</td></tr>
<tr><td>Kole Calhoun*	75</td></tr>
<tr><td>Arquimedes Caminero	0</td></tr>
<tr><td>Arquimedes Caminero	0</td></tr>
<tr><td>Eric Campbell	9</td></tr>
<tr><td>Leonel Campos	0</td></tr>
<tr><td>Vicente Campos	0</td></tr>
<tr><td>Jeimer Candelario#	0</td></tr>
<tr><td>Mark Canha	6</td></tr>
<tr><td>Robinson Cano*	103</td></tr>
<tr><td>Chris Capuano*	0</td></tr>
<tr><td>Matt Carasiti	0</td></tr>
<tr><td>Stephen Cardullo	6</td></tr>
<tr><td>Matt Carpenter*	68</td></tr>
<tr><td>Carlos Carrasco	0</td></tr>
<tr><td>Ezequiel Carrera*	23</td></tr>
<tr><td>Scott Carroll	0</td></tr>
<tr><td>Chris Carter	94</td></tr>
<tr><td>Curt Casali	25</td></tr>
<tr><td>Andrew Cashner	1</td></tr>
<tr><td>Andrew Cashner	0</td></tr>
<tr><td>Santiago Casilla	0</td></tr>
<tr><td>Nick Castellanos	58</td></tr>
<tr><td>Rusney Castillo	0</td></tr>
<tr><td>Welington Castillo	68</td></tr>
<tr><td>Daniel Castro	7</td></tr>
<tr><td>Jason Castro*	32</td></tr>
<tr><td>Miguel Castro	0</td></tr>
<tr><td>Starlin Castro	70</td></tr>
<tr><td>Gavin Cecchini	2</td></tr>
<tr><td>Brett Cecil	0</td></tr>
<tr><td>Darrell Ceciliani*	1</td></tr>
<tr><td>Xavier Cedeno*	0</td></tr>
<tr><td>Juan Centeno*	25</td></tr>
<tr><td>Francisco Cervelli	33</td></tr>
<tr><td>Hunter Cervenka*	0</td></tr>
<tr><td>Hunter Cervenka*	0</td></tr>
<tr><td>Yoenis Cespedes	86</td></tr>
<tr><td>Luis Cessa	0</td></tr>
<tr><td>Jhoulys Chacin	1</td></tr>
<tr><td>Jhoulys Chacin	0</td></tr>
<tr><td>Andrew Chafin	0</td></tr>
<tr><td>Joba Chamberlain	0</td></tr>
<tr><td>Aroldis Chapman*	0</td></tr>
<tr><td>Aroldis Chapman*	0</td></tr>
<tr><td>Kevin Chapman*	0</td></tr>
<tr><td>J.T. Chargois#	0</td></tr>
<tr><td>Tyler Chatwood	4</td></tr>
<tr><td>Jesse Chavez	0</td></tr>
<tr><td>Jesse Chavez	0</td></tr>
<tr><td>Wei-Yin Chen*	0</td></tr>
<tr><td>Robinson Chirinos	20</td></tr>
<tr><td>Lonnie Chisenhall*	57</td></tr>
<tr><td>Ji-Man Choi*	12</td></tr>
<tr><td>Shin-Soo Choo*	17</td></tr>
<tr><td>Tony Cingrani*	0</td></tr>
<tr><td>Steve Cishek	0</td></tr>
<tr><td>Alex Claudio*	0</td></tr>
<tr><td>Paul Clemens	0</td></tr>
<tr><td>Paul Clemens	0</td></tr>
<tr><td>Steve Clevenger*	7</td></tr>
<tr><td>Mike Clevinger	0</td></tr>
<tr><td>Tyler Clippard	0</td></tr>
<tr><td>Tyler Clippard	0</td></tr>
<tr><td>Jason Coats	4</td></tr>
<tr><td>Alex Cobb	0</td></tr>
<tr><td>Chris Coghlan*	14</td></tr>
<tr><td>Chris Coghlan*	16</td></tr>
<tr><td>Phil Coke*	0</td></tr>
<tr><td>Phil Coke*	0</td></tr>
<tr><td>Chris Colabello	1</td></tr>
<tr><td>A.J. Cole	0</td></tr>
<tr><td>Gerrit Cole	3</td></tr>
<tr><td>Louis Coleman	0</td></tr>
<tr><td>Tyler Collins*	15</td></tr>
<tr><td>Josh Collmenter	0</td></tr>
<tr><td>Josh Collmenter	0</td></tr>
<tr><td>Alex Colome	0</td></tr>
<tr><td>Bartolo Colon	2</td></tr>
<tr><td>Christian Colon	13</td></tr>
<tr><td>Joseph Colon	0</td></tr>
<tr><td>Gerardo Concepcion*	0</td></tr>
<tr><td>Michael Conforto*	42</td></tr>
<tr><td>Hank Conger#	10</td></tr>
<tr><td>Adam Conley*	3</td></tr>
<tr><td>Willson Contreras	35</td></tr>
<tr><td>Patrick Corbin*	4</td></tr>
<tr><td>Carlos Correa	96</td></tr>
<tr><td>Jarred Cosart	0</td></tr>
<tr><td>Jarred Cosart	0</td></tr>
<tr><td>Caleb Cotham	0</td></tr>
<tr><td>Jharel Cotton	0</td></tr>
<tr><td>Daniel Coulombe*	0</td></tr>
<tr><td>Kaleb Cowart#	8</td></tr>
<tr><td>Collin Cowgill	0</td></tr>
<tr><td>Zack Cozart	50</td></tr>
<tr><td>Tyler Cravy	1</td></tr>
<tr><td>Brandon Crawford*	84</td></tr>
<tr><td>Carl Crawford*	6</td></tr>
<tr><td>Coco Crisp#	47</td></tr>
<tr><td>Coco Crisp#	8</td></tr>
<tr><td>Kyle Crockett*	0</td></tr>
<tr><td>C.J. Cron	69</td></tr>
<tr><td>Nelson Cruz	105</td></tr>
<tr><td>Tony Cruz	1</td></tr>
<tr><td>Johnny Cueto	5</td></tr>
<tr><td>William Cuevas	0</td></tr>
<tr><td>Charlie Culberson	7</td></tr>
<tr><td>Brandon Cunniff	0</td></tr>
<tr><td>Todd Cunningham#	1</td></tr>
<tr><td>Zac Curtis*	0</td></tr>
<tr><td>Cheslor Cuthbert	46</td></tr>
<tr><td>Chase d'Arnaud	21</td></tr>
<tr><td>Travis d'Arnaud	15</td></tr>
<tr><td>David Dahl*	24</td></tr>
<tr><td>Tyler Danish	0</td></tr>
<tr><td>John Danks*	0</td></tr>
<tr><td>Yu Darvish	1</td></tr>
<tr><td>Matt Davidson	1</td></tr>
<tr><td>Zach Davies	1</td></tr>
<tr><td>Chris Davis*	84</td></tr>
<tr><td>Ike Davis*	1</td></tr>
<tr><td>Khris Davis	102</td></tr>
<tr><td>Rajai Davis	48</td></tr>
<tr><td>Wade Davis	0</td></tr>
<tr><td>Grant Dayton*	0</td></tr>
<tr><td>Alejandro De Aza*	25</td></tr>
<tr><td>Ivan De Jesus	20</td></tr>
<tr><td>Joel De La Cruz#	1</td></tr>
<tr><td>Jorge De La Rosa*	6</td></tr>
<tr><td>Rubby De La Rosa	1</td></tr>
<tr><td>Jose De Leon	0</td></tr>
<tr><td>Abel De Los Santos	0</td></tr>
<tr><td>Pat Dean*	0</td></tr>
<tr><td>Jaff Decker*	1</td></tr>
<tr><td>Jacob deGrom*	2</td></tr>
<tr><td>Steve Delabar	0</td></tr>
<tr><td>Randall Delgado	0</td></tr>
<tr><td>Matt den Dekker*	4</td></tr>
<tr><td>Matt Dermody	0</td></tr>
<tr><td>Daniel Descalso*	38</td></tr>
<tr><td>Anthony DeSclafani	1</td></tr>
<tr><td>Delino DeShields	13</td></tr>
<tr><td>Ian Desmond	86</td></tr>
<tr><td>Odrisamer Despaigne	0</td></tr>
<tr><td>Odrisamer Despaigne	0</td></tr>
<tr><td>Ross Detwiler	0</td></tr>
<tr><td>Ross Detwiler	0</td></tr>
<tr><td>Chris Devenski	0</td></tr>
<tr><td>Scott Diamond*	0</td></tr>
<tr><td>Aledmys Diaz	65</td></tr>
<tr><td>Dayan Diaz	0</td></tr>
<tr><td>Edwin Diaz	0</td></tr>
<tr><td>Elias Diaz	1</td></tr>
<tr><td>Jumbo Diaz	0</td></tr>
<tr><td>Alex Dickerson*	37</td></tr>
<tr><td>Corey Dickerson*	70</td></tr>
<tr><td>R.A. Dickey	0</td></tr>
<tr><td>Jake Diekman*	0</td></tr>
<tr><td>Derek Dietrich*	42</td></tr>
<tr><td>Wilmer Difo#	7</td></tr>
<tr><td>Jose Dominguez	0</td></tr>
<tr><td>Matt Dominguez	0</td></tr>
<tr><td>Josh Donaldson	99</td></tr>
<tr><td>Sean Doolittle*	0</td></tr>
<tr><td>Brian Dozier	99</td></tr>
<tr><td>Hunter Dozier	1</td></tr>
<tr><td>Kyle Drabek	0</td></tr>
<tr><td>Oliver Drake	0</td></tr>
<tr><td>Stephen Drew*	21</td></tr>
<tr><td>Brandon Drury	53</td></tr>
<tr><td>Lucas Duda*	23</td></tr>
<tr><td>Brian Duensing*	0</td></tr>
<tr><td>Tyler Duffey	0</td></tr>
<tr><td>Danny Duffy*	1</td></tr>
<tr><td>Matt Duffy	21</td></tr>
<tr><td>Matt Duffy	0</td></tr>
<tr><td>Matt Duffy	7</td></tr>
<tr><td>Zach Duke*	0</td></tr>
<tr><td>Zach Duke*	0</td></tr>
<tr><td>Ryan Dull	0</td></tr>
<tr><td>Mike Dunn*	0</td></tr>
<tr><td>Adam Duvall	103</td></tr>
<tr><td>Jarrod Dyson*	25</td></tr>
<tr><td>Sam Dyson	0</td></tr>
<tr><td>Adam Eaton*	59</td></tr>
<tr><td>Josh Edgin	0</td></tr>
<tr><td>Carl Edwards	0</td></tr>
<tr><td>Zach Eflin	0</td></tr>
<tr><td>Cody Ege*	0</td></tr>
<tr><td>Cody Ege*	0</td></tr>
<tr><td>Brett Eibner	10</td></tr>
<tr><td>Brett Eibner	12</td></tr>
<tr><td>Jerad Eickhoff	5</td></tr>
<tr><td>Roenis Elias*	0</td></tr>
<tr><td>Brian Ellington	0</td></tr>
<tr><td>A.J. Ellis	13</td></tr>
<tr><td>A.J. Ellis	9</td></tr>
<tr><td>Jacoby Ellsbury*	56</td></tr>
<tr><td>Jake Elmore	4</td></tr>
<tr><td>Edwin Encarnacion	127</td></tr>
<tr><td>Nathan Eovaldi	0</td></tr>
<tr><td>Robbie Erlin	0</td></tr>
<tr><td>Jake Esch	0</td></tr>
<tr><td>Alcides Escobar	55</td></tr>
<tr><td>Eduardo Escobar#	37</td></tr>
<tr><td>Edwin Escobar*	0</td></tr>
<tr><td>Yunel Escobar	39</td></tr>
<tr><td>Danny Espinosa#	72</td></tr>
<tr><td>Carlos Estevez	0</td></tr>
<tr><td>Marco Estrada	0</td></tr>
<tr><td>Andre Ethier*	2</td></tr>
<tr><td>Dana Eveland*	0</td></tr>
<tr><td>Jeurys Familia	0</td></tr>
<tr><td>Buck Farmer*	0</td></tr>
<tr><td>Danny Farquhar	0</td></tr>
<tr><td>Andrew Faulkner	0</td></tr>
<tr><td>Taylor Featherston	1</td></tr>
<tr><td>Tim Federowicz	3</td></tr>
<tr><td>Scott Feldman*	0</td></tr>
<tr><td>Scott Feldman*	0</td></tr>
<tr><td>Michael Feliz	0</td></tr>
<tr><td>Neftali Feliz	0</td></tr>
<tr><td>Jose Fernandez	6</td></tr>
<tr><td>Prince Fielder*	44</td></tr>
<tr><td>Josh Fields	0</td></tr>
<tr><td>Josh Fields	0</td></tr>
<tr><td>Casey Fien	0</td></tr>
<tr><td>Casey Fien	0</td></tr>
<tr><td>Mike Fiers	0</td></tr>
<tr><td>Cole Figueroa*	3</td></tr>
<tr><td>Brandon Finnegan*	2</td></tr>
<tr><td>Doug Fister*	2</td></tr>
<tr><td>Ryan Flaherty*	15</td></tr>
<tr><td>Yohan Flande*	0</td></tr>
<tr><td>Kendry Flores	0</td></tr>
<tr><td>Ramon Flores*	19</td></tr>
<tr><td>Wilmer Flores	49</td></tr>
<tr><td>Pedro Florimon#	4</td></tr>
<tr><td>Dylan Floro*	0</td></tr>
<tr><td>Tyler Flowers	41</td></tr>
<tr><td>Gavin Floyd	0</td></tr>
<tr><td>Brian Flynn*	0</td></tr>
<tr><td>Mike Foltynewicz	1</td></tr>
<tr><td>Logan Forsythe	52</td></tr>
<tr><td>Dexter Fowler#	48</td></tr>
<tr><td>Maikel Franco	88</td></tr>
<tr><td>Jeff Francoeur	33</td></tr>
<tr><td>Jeff Francoeur	1</td></tr>
<tr><td>Nick Franklin#	26</td></tr>
<tr><td>Adam Frazier*	11</td></tr>
<tr><td>Todd Frazier	98</td></tr>
<tr><td>Freddie Freeman*	91</td></tr>
<tr><td>Mike Freeman*	0</td></tr>
<tr><td>Mike Freeman*	1</td></tr>
<tr><td>Sam Freeman	0</td></tr>
<tr><td>David Freese	55</td></tr>
<tr><td>Carlos Frias	0</td></tr>
<tr><td>Christian Friedrich	2</td></tr>
<tr><td>Eric Fryer	5</td></tr>
<tr><td>Eric Fryer	8</td></tr>
<tr><td>Reymond Fuentes*	5</td></tr>
<tr><td>Carson Fulmer	0</td></tr>
<tr><td>Michael Fulmer	0</td></tr>
<tr><td>Yovani Gallardo	0</td></tr>
<tr><td>Joey Gallo*	1</td></tr>
<tr><td>Freddy Galvis#	67</td></tr>
<tr><td>Eddie Gamboa	0</td></tr>
<tr><td>Ben Gamel*	0</td></tr>
<tr><td>Ben Gamel*	5</td></tr>
<tr><td>John Gant	0</td></tr>
<tr><td>Adonis Garcia	65</td></tr>
<tr><td>Avisail Garcia	51</td></tr>
<tr><td>Greg Garcia*	17</td></tr>
<tr><td>Jaime Garcia*	4</td></tr>
<tr><td>Leury Garcia#	5</td></tr>
<tr><td>Luis Garcia	0</td></tr>
<tr><td>Yimi Garcia	0</td></tr>
<tr><td>Brett Gardner*	41</td></tr>
<tr><td>Dustin Garneau	6</td></tr>
<tr><td>Perci Garner	0</td></tr>
<tr><td>Ryan Garton	0</td></tr>
<tr><td>Matt Garza	0</td></tr>
<tr><td>Evan Gattis	72</td></tr>
<tr><td>Kevin Gausman*	0</td></tr>
<tr><td>Cory Gearrin	0</td></tr>
<tr><td>Dillon Gee	0</td></tr>
<tr><td>Steve Geltz	0</td></tr>
<tr><td>Scooter Gennett*	56</td></tr>
<tr><td>Craig Gentry	2</td></tr>
<tr><td>Gonzalez Germen	0</td></tr>
<tr><td>Johnny Giavotella	31</td></tr>
<tr><td>Kyle Gibson	0</td></tr>
<tr><td>Ken Giles	0</td></tr>
<tr><td>Conor Gillaspie*	25</td></tr>
<tr><td>Cole Gillespie	5</td></tr>
<tr><td>Sean Gilmartin*	0</td></tr>
<tr><td>Chris Gimenez	11</td></tr>
<tr><td>Lucas Giolito	0</td></tr>
<tr><td>Chad Girodo*	0</td></tr>
<tr><td>Mychal Givens	0</td></tr>
<tr><td>Tyler Glasnow*	0</td></tr>
<tr><td>Koda Glover	0</td></tr>
<tr><td>Zack Godley	0</td></tr>
<tr><td>Erik Goeddel	0</td></tr>
<tr><td>Tyler Goeddel	16</td></tr>
<tr><td>David Goforth	0</td></tr>
<tr><td>Ryan Goins*	12</td></tr>
<tr><td>Paul Goldschmidt	95</td></tr>
<tr><td>Yan Gomes	34</td></tr>
<tr><td>Carlos Gomez	29</td></tr>
<tr><td>Carlos Gomez	24</td></tr>
<tr><td>Jeanmar Gomez	0</td></tr>
<tr><td>Adrian Gonzalez*	90</td></tr>
<tr><td>Carlos Gonzalez*	100</td></tr>
<tr><td>Chi Chi Gonzalez	0</td></tr>
<tr><td>Erik Gonzalez	0</td></tr>
<tr><td>Gio Gonzalez	2</td></tr>
<tr><td>Marwin Gonzalez#	51</td></tr>
<tr><td>Miguel Gonzalez	0</td></tr>
<tr><td>Severino Gonzalez	0</td></tr>
<tr><td>Brian Goodwin*	5</td></tr>
<tr><td>Nick Goody	0</td></tr>
<tr><td>Alex Gordon*	40</td></tr>
<tr><td>Dee Gordon*	14</td></tr>
<tr><td>Terrance Gore	0</td></tr>
<tr><td>Tom Gorzelanny	0</td></tr>
<tr><td>Anthony Gose*	7</td></tr>
<tr><td>Tuffy Gosewisch	7</td></tr>
<tr><td>Philip Gosselin	13</td></tr>
<tr><td>Trevor Gott	0</td></tr>
<tr><td>Matt Grace*	0</td></tr>
<tr><td>J.R. Graham	0</td></tr>
<tr><td>Yasmani Grandal#	72</td></tr>
<tr><td>Curtis Granderson*	59</td></tr>
<tr><td>Juan Graterol	3</td></tr>
<tr><td>Kendall Graveman	0</td></tr>
<tr><td>Jon Gray	4</td></tr>
<tr><td>Sonny Gray	0</td></tr>
<tr><td>Chad Green*	0</td></tr>
<tr><td>Grant Green	7</td></tr>
<tr><td>Shane Greene	0</td></tr>
<tr><td>Luke Gregerson*	0</td></tr>
<tr><td>Didi Gregorius*	70</td></tr>
<tr><td>Zack Greinke	3</td></tr>
<tr><td>Randal Grichuk	68</td></tr>
<tr><td>A.J. Griffin	0</td></tr>
<tr><td>Jason Grilli	0</td></tr>
<tr><td>Jason Grilli	0</td></tr>
<tr><td>Justin Grimm	0</td></tr>
<tr><td>Robbie Grossman#	37</td></tr>
<tr><td>Robert Gsellman	0</td></tr>
<tr><td>Mayckol Guaipe	0</td></tr>
<tr><td>Deolis Guerra	0</td></tr>
<tr><td>Javy Guerra	0</td></tr>
<tr><td>Junior Guerra	0</td></tr>
<tr><td>Tayron Guerrero	0</td></tr>
<tr><td>Jason Gurka*	0</td></tr>
<tr><td>Yulieski Gurriel	15</td></tr>
<tr><td>Jandel Gustave	0</td></tr>
<tr><td>Franklin Gutierrez	39</td></tr>
<tr><td>Brandon Guyer	18</td></tr>
<tr><td>Brandon Guyer	14</td></tr>
<tr><td>Jedd Gyorko	59</td></tr>
<tr><td>Jesse Hahn	0</td></tr>
<tr><td>David Hale	0</td></tr>
<tr><td>Cody Hall	0</td></tr>
<tr><td>Cole Hamels*	0</td></tr>
<tr><td>Billy Hamilton#	17</td></tr>
<tr><td>Jason Hammel	7</td></tr>
<tr><td>Brad Hand*	0</td></tr>
<tr><td>Ryan Hanigan	14</td></tr>
<tr><td>Mitch Haniger	17</td></tr>
<tr><td>Alen Hanson#	1</td></tr>
<tr><td>J.A. Happ*	0</td></tr>
<tr><td>Blaine Hardy*	0</td></tr>
<tr><td>J.J. Hardy	48</td></tr>
<tr><td>Bryce Harper*	86</td></tr>
<tr><td>Lucas Harrell#	0</td></tr>
<tr><td>Lucas Harrell#	0</td></tr>
<tr><td>Will Harris	0</td></tr>
<tr><td>Josh Harrison	59</td></tr>
<tr><td>Donnie Hart*	0</td></tr>
<tr><td>Matt Harvey	0</td></tr>
<tr><td>Chris Hatcher#	1</td></tr>
<tr><td>Steve Hathaway*	0</td></tr>
<tr><td>Drew Hayes	0</td></tr>
<tr><td>Jeremy Hazelbaker*	28</td></tr>
<tr><td>Chase Headley#	51</td></tr>
<tr><td>Ryon Healy	37</td></tr>
<tr><td>Andrew Heaney*	0</td></tr>
<tr><td>Adeiny Hechavarria	38</td></tr>
<tr><td>Austin Hedges	1</td></tr>
<tr><td>Chris Heisey	17</td></tr>
<tr><td>Ben Heller	0</td></tr>
<tr><td>Jeremy Hellickson	4</td></tr>
<tr><td>Heath Hembree	0</td></tr>
<tr><td>Jim Henderson*	0</td></tr>
<tr><td>Kyle Hendricks	2</td></tr>
<tr><td>Liam Hendriks	0</td></tr>
<tr><td>Guillermo Heredia	12</td></tr>
<tr><td>Cesar Hernandez#	39</td></tr>
<tr><td>David Hernandez	0</td></tr>
<tr><td>Enrique Hernandez	18</td></tr>
<tr><td>Felix Hernandez	0</td></tr>
<tr><td>Gorkys Hernandez	4</td></tr>
<tr><td>Marco Hernandez*	5</td></tr>
<tr><td>Oscar Hernandez	1</td></tr>
<tr><td>Roberto Hernandez	0</td></tr>
<tr><td>Teoscar Hernandez	11</td></tr>
<tr><td>Kelvin Herrera	0</td></tr>
<tr><td>Odubel Herrera*	49</td></tr>
<tr><td>Chris Herrmann*	28</td></tr>
<tr><td>Frank Herrmann*	0</td></tr>
<tr><td>Keith Hessler*	0</td></tr>
<tr><td>Keith Hessler*	0</td></tr>
<tr><td>Chris Heston	0</td></tr>
<tr><td>Jason Heyward*	49</td></tr>
<tr><td>Aaron Hicks#	31</td></tr>
<tr><td>John Hicks	0</td></tr>
<tr><td>Aaron Hill	29</td></tr>
<tr><td>Aaron Hill	9</td></tr>
<tr><td>Rich Hill*	0</td></tr>
<tr><td>Rich Hill*	0</td></tr>
<tr><td>Dalier Hinojosa	0</td></tr>
<tr><td>Luke Hochevar	0</td></tr>
<tr><td>Jeff Hoffman	0</td></tr>
<tr><td>Bryan Holaday	13</td></tr>
<tr><td>Bryan Holaday	1</td></tr>
<tr><td>Jonathan Holder	0</td></tr>
<tr><td>Derek Holland#	0</td></tr>
<tr><td>Matt Holliday	62</td></tr>
<tr><td>Brock Holt*	34</td></tr>
<tr><td>Tyler Holt	13</td></tr>
<tr><td>Destin Hood	2</td></tr>
<tr><td>J.J. Hoover	0</td></tr>
<tr><td>Eric Hosmer*	104</td></tr>
<tr><td>T.J. House	0</td></tr>
<tr><td>Ryan Howard*	59</td></tr>
<tr><td>J.P. Howell*	0</td></tr>
<tr><td>Jared Hoying*	5</td></tr>
<tr><td>James Hoyt	0</td></tr>
<tr><td>Daniel Hudson	0</td></tr>
<tr><td>David Huff#	0</td></tr>
<tr><td>Jared Hughes	0</td></tr>
<tr><td>Phil Hughes	0</td></tr>
<tr><td>Nick Hundley	48</td></tr>
<tr><td>Cedric Hunter*	1</td></tr>
<tr><td>Tommy Hunter	0</td></tr>
<tr><td>Tommy Hunter	0</td></tr>
<tr><td>Jason Hursh	0</td></tr>
<tr><td>Drew Hutchison*	0</td></tr>
<tr><td>Drew Hutchison*	0</td></tr>
<tr><td>Chris Iannetta	24</td></tr>
<tr><td>Jose Iglesias	32</td></tr>
<tr><td>Raisel Iglesias	0</td></tr>
<tr><td>Ender Inciarte*	29</td></tr>
<tr><td>Omar Infante	11</td></tr>
<tr><td>Hernan Iribarren*	2</td></tr>
<tr><td>Hisashi Iwakuma	0</td></tr>
<tr><td>Austin Jackson	18</td></tr>
<tr><td>Edwin Jackson	0</td></tr>
<tr><td>Edwin Jackson	2</td></tr>
<tr><td>Luke Jackson	0</td></tr>
<tr><td>Paul Janish	0</td></tr>
<tr><td>Travis Jankowski*	12</td></tr>
<tr><td>Kenley Jansen#	0</td></tr>
<tr><td>John Jaso*	42</td></tr>
<tr><td>Jon Jay*	26</td></tr>
<tr><td>Jeremy Jeffress	0</td></tr>
<tr><td>Jeremy Jeffress	0</td></tr>
<tr><td>Tyrell Jenkins	0</td></tr>
<tr><td>Dan Jennings*	0</td></tr>
<tr><td>Desmond Jennings	20</td></tr>
<tr><td>Kyle Jensen	7</td></tr>
<tr><td>Kevin Jepsen	0</td></tr>
<tr><td>Kevin Jepsen	0</td></tr>
<tr><td>Ubaldo Jimenez	0</td></tr>
<tr><td>Chris Johnson	24</td></tr>
<tr><td>Erik Johnson	0</td></tr>
<tr><td>Erik Johnson	0</td></tr>
<tr><td>Jim Johnson	0</td></tr>
<tr><td>Kelly Johnson*	10</td></tr>
<tr><td>Kelly Johnson*	24</td></tr>
<tr><td>Micah Johnson*	0</td></tr>
<tr><td>Steve Johnson	0</td></tr>
<tr><td>Adam Jones	83</td></tr>
<tr><td>JaCoby Jones	2</td></tr>
<tr><td>Nate Jones	0</td></tr>
<tr><td>Caleb Joseph	0</td></tr>
<tr><td>Tommy Joseph	47</td></tr>
<tr><td>Matthew Joyce*	42</td></tr>
<tr><td>Aaron Judge	10</td></tr>
<tr><td>Taylor Jungmann	0</td></tr>
<tr><td>Tommy Kahnle	0</td></tr>
<tr><td>Ryan Kalish*	2</td></tr>
<tr><td>Jung Ho Kang	62</td></tr>
<tr><td>Nate Karns	0</td></tr>
<tr><td>Munenori Kawasaki*	1</td></tr>
<tr><td>Scott Kazmir*	2</td></tr>
<tr><td>Keone Kela	0</td></tr>
<tr><td>Shawn Kelley	0</td></tr>
<tr><td>Carson Kelly	1</td></tr>
<tr><td>Casey Kelly	0</td></tr>
<tr><td>Don Kelly*	3</td></tr>
<tr><td>Joe Kelly	0</td></tr>
<tr><td>Ty Kelly#	7</td></tr>
<tr><td>Matt Kemp	69</td></tr>
<tr><td>Matt Kemp	39</td></tr>
<tr><td>Tony Kemp*	7</td></tr>
<tr><td>Howie Kendrick	40</td></tr>
<tr><td>Ian Kennedy	0</td></tr>
<tr><td>Logan Kensing	0</td></tr>
<tr><td>Max Kepler*	63</td></tr>
<tr><td>Clayton Kershaw*	3</td></tr>
<tr><td>Dallas Keuchel*	0</td></tr>
<tr><td>Spencer Kieboom	0</td></tr>
<tr><td>Dean Kiekhefer*	0</td></tr>
<tr><td>Kevin Kiermaier*	37</td></tr>
<tr><td>Hyun Soo Kim*	22</td></tr>
<tr><td>Craig Kimbrel	0</td></tr>
<tr><td>Ian Kinsler	83</td></tr>
<tr><td>Brandon Kintzler	0</td></tr>
<tr><td>Jason Kipnis*	82</td></tr>
<tr><td>Michael Kirkman*	0</td></tr>
<tr><td>Michael Kirkman*	0</td></tr>
<tr><td>Patrick Kivlehan	2</td></tr>
<tr><td>Patrick Kivlehan	0</td></tr>
<tr><td>Phil Klein	0</td></tr>
<tr><td>Phil Klein	0</td></tr>
<tr><td>Corey Kluber	0</td></tr>
<tr><td>Corey Knebel	0</td></tr>
<tr><td>Matt Koch*	0</td></tr>
<tr><td>Tom Koehler	4</td></tr>
<tr><td>George Kontos	0</td></tr>
<tr><td>Erik Kratz	0</td></tr>
<tr><td>Erik Kratz	4</td></tr>
<tr><td>Ian Krol*	0</td></tr>
<tr><td>Chad Kuhl	0</td></tr>
<tr><td>Tommy La Stella*	11</td></tr>
<tr><td>John Lackey	2</td></tr>
<tr><td>Tyler Ladendorf	1</td></tr>
<tr><td>Juan Lagares	9</td></tr>
<tr><td>Junior Lake	2</td></tr>
<tr><td>Blake Lalli*	1</td></tr>
<tr><td>Ryan LaMarre	0</td></tr>
<tr><td>Jake Lamb*	91</td></tr>
<tr><td>John Lamb*	0</td></tr>
<tr><td>Andrew Lambo*	0</td></tr>
<tr><td>Mat Latos	0</td></tr>
<tr><td>Mat Latos	1</td></tr>
<tr><td>Derek Law	0</td></tr>
<tr><td>Brett Lawrie	36</td></tr>
<tr><td>Tommy Layne*	0</td></tr>
<tr><td>Tommy Layne*	0</td></tr>
<tr><td>Mike Leake	4</td></tr>
<tr><td>Wade LeBlanc*	0</td></tr>
<tr><td>Wade LeBlanc*	0</td></tr>
<tr><td>Jose Leclerc	0</td></tr>
<tr><td>Dae-ho Lee	49</td></tr>
<tr><td>DJ LeMahieu	66</td></tr>
<tr><td>Arnold Leon	0</td></tr>
<tr><td>Sandy Leon#	35</td></tr>
<tr><td>Dominic Leone	0</td></tr>
<tr><td>Jon Lester*	6</td></tr>
<tr><td>Colby Lewis	0</td></tr>
<tr><td>Adam Liberatore*	0</td></tr>
<tr><td>Pat Light	0</td></tr>
<tr><td>Pat Light	0</td></tr>
<tr><td>Tim Lincecum*	0</td></tr>
<tr><td>Adam Lind*	58</td></tr>
<tr><td>Francisco Lindor#	78</td></tr>
<tr><td>Francisco Liriano*	5</td></tr>
<tr><td>Francisco Liriano*	0</td></tr>
<tr><td>Jose Lobaton#	8</td></tr>
<tr><td>Kyle Lobstein*	0</td></tr>
<tr><td>Jeff Locke*	0</td></tr>
<tr><td>Adam Loewen*	0</td></tr>
<tr><td>Boone Logan	0</td></tr>
<tr><td>Kyle Lohse	0</td></tr>
<tr><td>James Loney*	34</td></tr>
<tr><td>Evan Longoria	98</td></tr>
<tr><td>Javier Lopez*	0</td></tr>
<tr><td>Rafael Lopez*	0</td></tr>
<tr><td>Reynaldo Lopez	0</td></tr>
<tr><td>Michael Lorenzen	3</td></tr>
<tr><td>David Lough*	4</td></tr>
<tr><td>Aaron Loup*	0</td></tr>
<tr><td>Mark Lowe*	0</td></tr>
<tr><td>Jed Lowrie#	27</td></tr>
<tr><td>Jonathan Lucroy	50</td></tr>
<tr><td>Jonathan Lucroy	31</td></tr>
<tr><td>Cory Luebke	0</td></tr>
<tr><td>Seth Lugo	1</td></tr>
<tr><td>Jordan Lyles	0</td></tr>
<tr><td>Tyler Lyons*	0</td></tr>
<tr><td>Dixon Machado	0</td></tr>
<tr><td>Manny Machado	96</td></tr>
<tr><td>Ryan Madson*	0</td></tr>
<tr><td>Kenta Maeda	4</td></tr>
<tr><td>Matt Magill	0</td></tr>
<tr><td>Damien Magnifico	0</td></tr>
<tr><td>Greg Mahle*	0</td></tr>
<tr><td>Mikie Mahtook	11</td></tr>
<tr><td>Luke Maile	15</td></tr>
<tr><td>Martin Maldonado	21</td></tr>
<tr><td>Sean Manaea*	0</td></tr>
<tr><td>Trey Mancini	5</td></tr>
<tr><td>Seth Maness	0</td></tr>
<tr><td>Jeff Manship	0</td></tr>
<tr><td>Joe Mantiply	0</td></tr>
<tr><td>Manuel Margot	3</td></tr>
<tr><td>Jhan Marinez	0</td></tr>
<tr><td>Jhan Marinez	0</td></tr>
<tr><td>Michael Mariot	0</td></tr>
<tr><td>Jake Marisnick	21</td></tr>
<tr><td>Nick Markakis*	89</td></tr>
<tr><td>Justin Marks*	0</td></tr>
<tr><td>Matt Marksberry*	0</td></tr>
<tr><td>German Marquez	0</td></tr>
<tr><td>Deven Marrero	0</td></tr>
<tr><td>Evan Marshall	0</td></tr>
<tr><td>Jefry Marte	44</td></tr>
<tr><td>Kelvin Marte	0</td></tr>
<tr><td>Ketel Marte#	33</td></tr>
<tr><td>Starling Marte	46</td></tr>
<tr><td>Cody Martin	0</td></tr>
<tr><td>Leonys Martin*	47</td></tr>
<tr><td>Rafael Martin	0</td></tr>
<tr><td>Russell Martin	74</td></tr>
<tr><td>Carlos Martinez	6</td></tr>
<tr><td>J.D. Martinez	68</td></tr>
<tr><td>Jose Martinez	1</td></tr>
<tr><td>Michael Martinez#	0</td></tr>
<tr><td>Michael Martinez#	4</td></tr>
<tr><td>Nick Martinez*	0</td></tr>
<tr><td>Victor Martinez#	86</td></tr>
<tr><td>Darin Mastroianni	0</td></tr>
<tr><td>Jeff Mathis	15</td></tr>
<tr><td>Brian Matusz*	0</td></tr>
<tr><td>Brian Matusz*	0</td></tr>
<tr><td>Steven Matz	2</td></tr>
<tr><td>Joe Mauer*	49</td></tr>
<tr><td>Brandon Maurer	0</td></tr>
<tr><td>Bruce Maxwell*	14</td></tr>
<tr><td>Trevor May	0</td></tr>
<tr><td>Cameron Maybin	43</td></tr>
<tr><td>Mike Mayers	0</td></tr>
<tr><td>Nomar Mazara*	64</td></tr>
<tr><td>Vin Mazzaro	0</td></tr>
<tr><td>Zach McAllister	0</td></tr>
<tr><td>Matt McBride	2</td></tr>
<tr><td>Brian McCann*	58</td></tr>
<tr><td>James McCann	48</td></tr>
<tr><td>Brandon McCarthy	1</td></tr>
<tr><td>Kevin McCarthy	0</td></tr>
<tr><td>Lance McCullers*	0</td></tr>
<tr><td>Andrew McCutchen	79</td></tr>
<tr><td>T.J. McFarland*	0</td></tr>
<tr><td>Jake McGee*	0</td></tr>
<tr><td>Casey McGehee	1</td></tr>
<tr><td>Dustin McGowan	0</td></tr>
<tr><td>Collin McHugh	0</td></tr>
<tr><td>Michael McKenry	0</td></tr>
<tr><td>Kris Medlen#	0</td></tr>
<tr><td>Adalberto Mejia	0</td></tr>
<tr><td>Mark Melancon	0</td></tr>
<tr><td>Mark Melancon	0</td></tr>
<tr><td>Tim Melville	0</td></tr>
<tr><td>Yohander Mendez*	0</td></tr>
<tr><td>Daniel Mengden	0</td></tr>
<tr><td>Jordy Mercer	59</td></tr>
<tr><td>Whit Merrifield	29</td></tr>
<tr><td>Ryan Merritt*	0</td></tr>
<tr><td>Devin Mesoraco	1</td></tr>
<tr><td>Alex Meyer	0</td></tr>
<tr><td>Alex Meyer	0</td></tr>
<tr><td>Will Middlebrooks	1</td></tr>
<tr><td>Wade Miley*	0</td></tr>
<tr><td>Wade Miley*	0</td></tr>
<tr><td>Andrew Miller*	0</td></tr>
<tr><td>Andrew Miller*	0</td></tr>
<tr><td>Brad Miller*	81</td></tr>
<tr><td>Justin Miller	0</td></tr>
<tr><td>Mike Miller	0</td></tr>
<tr><td>Shelby Miller	0</td></tr>
<tr><td>Alec Mills	0</td></tr>
<tr><td>Tommy Milone*	0</td></tr>
<tr><td>Juan Minaya	0</td></tr>
<tr><td>Ariel Miranda*	0</td></tr>
<tr><td>Ariel Miranda*	0</td></tr>
<tr><td>Bryan Mitchell*	0</td></tr>
<tr><td>Yadier Molina	58</td></tr>
<tr><td>Dustin Molleken*	0</td></tr>
<tr><td>Yoan Moncada#	1</td></tr>
<tr><td>Raul Mondesi#	13</td></tr>
<tr><td>Miguel Montero*	33</td></tr>
<tr><td>Rafael Montero	0</td></tr>
<tr><td>Mike Montgomery*	0</td></tr>
<tr><td>Mike Montgomery*	1</td></tr>
<tr><td>Adam Moore	0</td></tr>
<tr><td>Matt Moore*	0</td></tr>
<tr><td>Matt Moore*	0</td></tr>
<tr><td>Franklin Morales*	0</td></tr>
<tr><td>Kendrys Morales#	93</td></tr>
<tr><td>Colin Moran*	2</td></tr>
<tr><td>Mitch Moreland*	60</td></tr>
<tr><td>Adam Morgan*	1</td></tr>
<tr><td>Shawn Morimando*	0</td></tr>
<tr><td>Mike Morin	0</td></tr>
<tr><td>Justin Morneau*	25</td></tr>
<tr><td>Max Moroff#	0</td></tr>
<tr><td>A.J. Morris	0</td></tr>
<tr><td>Bryan Morris*	0</td></tr>
<tr><td>Logan Morrison*	43</td></tr>
<tr><td>Brandon Morrow	0</td></tr>
<tr><td>Mike Morse	0</td></tr>
<tr><td>Charlie Morton	0</td></tr>
<tr><td>Jon Moscot	0</td></tr>
<tr><td>Brandon Moss*	67</td></tr>
<tr><td>Jason Motte	0</td></tr>
<tr><td>Taylor Motter	9</td></tr>
<tr><td>Mike Moustakas*	13</td></tr>
<tr><td>Steven Moya*	11</td></tr>
<tr><td>Peter Moylan	0</td></tr>
<tr><td>Conor Mullee	0</td></tr>
<tr><td>Max Muncy*	8</td></tr>
<tr><td>Daniel Murphy*	104</td></tr>
<tr><td>John Ryan Murphy	3</td></tr>
<tr><td>Tom Murphy	13</td></tr>
<tr><td>Colton Murray	0</td></tr>
<tr><td>Joseph Musgrove	0</td></tr>
<tr><td>Wil Myers	94</td></tr>
<tr><td>Mike Napoli	101</td></tr>
<tr><td>Tyler Naquin*	43</td></tr>
<tr><td>Omar Narvaez*	10</td></tr>
<tr><td>Chris Narveson*	0</td></tr>
<tr><td>Joe Nathan	0</td></tr>
<tr><td>Joe Nathan	0</td></tr>
<tr><td>Daniel Nava#	13</td></tr>
<tr><td>Daniel Nava#	0</td></tr>
<tr><td>Dioner Navarro#	32</td></tr>
<tr><td>Dioner Navarro#	3</td></tr>
<tr><td>Zach Neal	0</td></tr>
<tr><td>Jimmy Nelson	3</td></tr>
<tr><td>Hector Neris	0</td></tr>
<tr><td>Pat Neshek#	0</td></tr>
<tr><td>Juan Nicasio	1</td></tr>
<tr><td>Brett Nicholas*	4</td></tr>
<tr><td>Justin Nicolino*	0</td></tr>
<tr><td>Jon Niese*	1</td></tr>
<tr><td>Jon Niese*	0</td></tr>
<tr><td>Kirk Nieuwenhuis*	44</td></tr>
<tr><td>Brandon Nimmo*	6</td></tr>
<tr><td>Aaron Nola	0</td></tr>
<tr><td>Ricky Nolasco	0</td></tr>
<tr><td>Ricky Nolasco	0</td></tr>
<tr><td>Nick Noonan*	1</td></tr>
<tr><td>Bud Norris	0</td></tr>
<tr><td>Bud Norris	1</td></tr>
<tr><td>Daniel Norris*	0</td></tr>
<tr><td>Derek Norris	42</td></tr>
<tr><td>Ivan Nova	0</td></tr>
<tr><td>Ivan Nova	0</td></tr>
<tr><td>Eduardo Nunez	47</td></tr>
<tr><td>Eduardo Nunez	20</td></tr>
<tr><td>Renato Nunez	1</td></tr>
<tr><td>Vidal Nuno*	0</td></tr>
<tr><td>Peter O'Brien	9</td></tr>
<tr><td>Darren O'Day	0</td></tr>
<tr><td>Eric O'Flaherty*	0</td></tr>
<tr><td>Shawn O'Malley#	17</td></tr>
<tr><td>Ryan O'Rourke	0</td></tr>
<tr><td>Sean O'Sullivan	0</td></tr>
<tr><td>Scott Oberg	0</td></tr>
<tr><td>Brett Oberholtzer*	0</td></tr>
<tr><td>Brett Oberholtzer*	0</td></tr>
<tr><td>Rougned Odor*	88</td></tr>
<tr><td>Jake Odorizzi	1</td></tr>
<tr><td>Alexi Ogando	0</td></tr>
<tr><td>Nefi Ogando	0</td></tr>
<tr><td>Seung-hwan Oh	0</td></tr>
<tr><td>Ross Ohlendorf	0</td></tr>
<tr><td>Steven Okert*	0</td></tr>
<tr><td>Hector Olivera	2</td></tr>
<tr><td>Matt Olson*	0</td></tr>
<tr><td>Tyler Olson	0</td></tr>
<tr><td>Logan Ondrusek	0</td></tr>
<tr><td>Paulo Orlando	43</td></tr>
<tr><td>Rafael Ortega*	16</td></tr>
<tr><td>David Ortiz*	127</td></tr>
<tr><td>Josh Osich*	0</td></tr>
<tr><td>Roberto Osuna	0</td></tr>
<tr><td>Dan Otero	0</td></tr>
<tr><td>Adam Ottavino#	0</td></tr>
<tr><td>Dillon Overton*	0</td></tr>
<tr><td>Henry Owens*	0</td></tr>
<tr><td>Chris Owings	49</td></tr>
<tr><td>Marcell Ozuna	76</td></tr>
<tr><td>Jordan Pacheco	0</td></tr>
<tr><td>Angel Pagan#	55</td></tr>
<tr><td>Joe Panik*	62</td></tr>
<tr><td>Jonathan Papelbon	0</td></tr>
<tr><td>Jimmy Paredes#	2</td></tr>
<tr><td>Jimmy Paredes#	17</td></tr>
<tr><td>Byung Ho Park	24</td></tr>
<tr><td>Blake Parker	0</td></tr>
<tr><td>Blake Parker	0</td></tr>
<tr><td>Jarrett Parker*	14</td></tr>
<tr><td>Chris Parmelee*	4</td></tr>
<tr><td>Bobby Parnell	0</td></tr>
<tr><td>Gerardo Parra*	39</td></tr>
<tr><td>Curtis Partch	0</td></tr>
<tr><td>Jordan Patterson*	2</td></tr>
<tr><td>Spencer Patton	0</td></tr>
<tr><td>David Paulino	0</td></tr>
<tr><td>Ben Paulsen*	11</td></tr>
<tr><td>James Paxton*	0</td></tr>
<tr><td>James Pazos	0</td></tr>
<tr><td>Brad Peacock	0</td></tr>
<tr><td>Steve Pearce	29</td></tr>
<tr><td>Steve Pearce	6</td></tr>
<tr><td>Jake Peavy	3</td></tr>
<tr><td>Joc Pederson*	68</td></tr>
<tr><td>Dustin Pedroia	74</td></tr>
<tr><td>Mike Pelfrey	0</td></tr>
<tr><td>Ariel Pena	0</td></tr>
<tr><td>Brayan Pena#	0</td></tr>
<tr><td>Felix Pena	0</td></tr>
<tr><td>Francisco Pena	3</td></tr>
<tr><td>Ramiro Pena#	10</td></tr>
<tr><td>Hunter Pence	57</td></tr>
<tr><td>Cliff Pennington#	10</td></tr>
<tr><td>David Peralta*	15</td></tr>
<tr><td>Jhonny Peralta	29</td></tr>
<tr><td>Joel Peralta	0</td></tr>
<tr><td>Joel Peralta	0</td></tr>
<tr><td>Wandy Peralta*	0</td></tr>
<tr><td>Wily Peralta	6</td></tr>
<tr><td>Jose Peraza	25</td></tr>
<tr><td>Luis Perdomo	1</td></tr>
<tr><td>Carlos Perez	31</td></tr>
<tr><td>Hernan Perez	56</td></tr>
<tr><td>Martin Perez*	0</td></tr>
<tr><td>Oliver Perez*	0</td></tr>
<tr><td>Roberto Perez	17</td></tr>
<tr><td>Salvador Perez	64</td></tr>
<tr><td>Williams Perez	0</td></tr>
<tr><td>Yefri Perez#	0</td></tr>
<tr><td>Glen Perkins*	0</td></tr>
<tr><td>Jace Peterson*	29</td></tr>
<tr><td>Gregorio Petit	17</td></tr>
<tr><td>Yusmeiro Petit	0</td></tr>
<tr><td>Jake Petricka	0</td></tr>
<tr><td>Tommy Pham	17</td></tr>
<tr><td>Josh Phegley	10</td></tr>
<tr><td>David Phelps	1</td></tr>
<tr><td>Brandon Phillips	64</td></tr>
<tr><td>Zach Phillips*	0</td></tr>
<tr><td>A.J. Pierzynski*	23</td></tr>
<tr><td>Kevin Pillar	53</td></tr>
<tr><td>Manny Pina	12</td></tr>
<tr><td>Branden Pinder	0</td></tr>
<tr><td>Chad Pinder	4</td></tr>
<tr><td>Michael Pineda	0</td></tr>
<tr><td>Josmil Pinto	0</td></tr>
<tr><td>Jose Pirela	0</td></tr>
<tr><td>Stephen Piscotty	85</td></tr>
<tr><td>Kevin Plawecki	11</td></tr>
<tr><td>Trevor Plouffe	47</td></tr>
<tr><td>Adam Plutko	0</td></tr>
<tr><td>Gregory Polanco*	86</td></tr>
<tr><td>Jorge Polanco#	27</td></tr>
<tr><td>A.J. Pollock	4</td></tr>
<tr><td>Drew Pomeranz	4</td></tr>
<tr><td>Drew Pomeranz	0</td></tr>
<tr><td>Dalton Pompey#	0</td></tr>
<tr><td>Rick Porcello	0</td></tr>
<tr><td>Buster Posey	80</td></tr>
<tr><td>Brooks Pounders	0</td></tr>
<tr><td>Martin Prado	75</td></tr>
<tr><td>Alex Presley*	11</td></tr>
<tr><td>Alex Presley*	0</td></tr>
<tr><td>Ryan Pressly	0</td></tr>
<tr><td>David Price*	0</td></tr>
<tr><td>Jurickson Profar#	20</td></tr>
<tr><td>Yasiel Puig	45</td></tr>
<tr><td>Albert Pujols	119</td></tr>
<tr><td>Matt Purke*	0</td></tr>
<tr><td>Zach Putnam	0</td></tr>
<tr><td>Kevin Quackenbush	0</td></tr>
<tr><td>Chad Qualls	0</td></tr>
<tr><td>Juniel Querecuto#	2</td></tr>
<tr><td>Roman Quinn#	6</td></tr>
<tr><td>Jose Quintana	0</td></tr>
<tr><td>Ryan Raburn	30</td></tr>
<tr><td>Alexei Ramirez	41</td></tr>
<tr><td>Alexei Ramirez	7</td></tr>
<tr><td>Erasmo Ramirez	0</td></tr>
<tr><td>Hanley Ramirez	111</td></tr>
<tr><td>J.C. Ramirez	0</td></tr>
<tr><td>J.C. Ramirez	0</td></tr>
<tr><td>Jose Ramirez	0</td></tr>
<tr><td>Jose Ramirez#	76</td></tr>
<tr><td>Neil Ramirez	0</td></tr>
<tr><td>Neil Ramirez	0</td></tr>
<tr><td>Neil Ramirez	0</td></tr>
<tr><td>Noe Ramirez	0</td></tr>
<tr><td>A.J. Ramos	0</td></tr>
<tr><td>Cesar Ramos*	0</td></tr>
<tr><td>Edubray Ramos	0</td></tr>
<tr><td>Wilson Ramos	80</td></tr>
<tr><td>Anthony Ranaudo	0</td></tr>
<tr><td>Anthony Ranaudo	1</td></tr>
<tr><td>Colby Rasmus*	54</td></tr>
<tr><td>Cory Rasmus	0</td></tr>
<tr><td>Josh Ravin	0</td></tr>
<tr><td>Robbie Ray*	2</td></tr>
<tr><td>Colin Rea	1</td></tr>
<tr><td>Colin Rea	0</td></tr>
<tr><td>J.T. Realmuto	48</td></tr>
<tr><td>Anthony Recker	15</td></tr>
<tr><td>Josh Reddick*	28</td></tr>
<tr><td>Josh Reddick*	9</td></tr>
<tr><td>A.J. Reed*	8</td></tr>
<tr><td>Addison Reed*	0</td></tr>
<tr><td>Cody Reed*	0</td></tr>
<tr><td>Michael Reed	0</td></tr>
<tr><td>Rob Refsnyder	12</td></tr>
<tr><td>Nolan Reimold	15</td></tr>
<tr><td>Tony Renda	3</td></tr>
<tr><td>Anthony Rendon	85</td></tr>
<tr><td>Hunter Renfroe	14</td></tr>
<tr><td>Ben Revere*	24</td></tr>
<tr><td>Alex Reyes	1</td></tr>
<tr><td>Jo-Jo Reyes*	0</td></tr>
<tr><td>Jose Reyes#	24</td></tr>
<tr><td>Mark Reynolds	53</td></tr>
<tr><td>Matt Reynolds*	0</td></tr>
<tr><td>Matt Reynolds	13</td></tr>
<tr><td>Clayton Richard*	0</td></tr>
<tr><td>Clayton Richard*	1</td></tr>
<tr><td>Garrett Richards	0</td></tr>
<tr><td>Joey Rickard	19</td></tr>
<tr><td>Rene Rivera	26</td></tr>
<tr><td>T.J. Rivera	16</td></tr>
<tr><td>Yadiel Rivera	3</td></tr>
<tr><td>Felipe Rivero*	0</td></tr>
<tr><td>Felipe Rivero*	0</td></tr>
<tr><td>Anthony Rizzo*	109</td></tr>
<tr><td>Donn Roach	0</td></tr>
<tr><td>Tanner Roark	3</td></tr>
<tr><td>Dan Robertson	1</td></tr>
<tr><td>David Robertson	0</td></tr>
<tr><td>Clint Robinson*	26</td></tr>
<tr><td>Shane Robinson	10</td></tr>
<tr><td>Hansel Robles	0</td></tr>
<tr><td>Brady Rodgers	0</td></tr>
<tr><td>Fernando Rodney	0</td></tr>
<tr><td>Fernando Rodney	0</td></tr>
<tr><td>Carlos Rodon*	0</td></tr>
<tr><td>Alex Rodriguez	31</td></tr>
<tr><td>Eduardo Rodriguez*	0</td></tr>
<tr><td>Fernando Rodriguez	0</td></tr>
<tr><td>Francisco Rodriguez	0</td></tr>
<tr><td>Joely Rodriguez*	0</td></tr>
<tr><td>Sean Rodriguez	56</td></tr>
<tr><td>Chaz Roe	0</td></tr>
<tr><td>Chaz Roe	0</td></tr>
<tr><td>Jason Rogers	2</td></tr>
<tr><td>Taylor Rogers*	0</td></tr>
<tr><td>Miguel Rojas	14</td></tr>
<tr><td>David Rollins*	0</td></tr>
<tr><td>Jimmy Rollins#	8</td></tr>
<tr><td>Enny Romero*	0</td></tr>
<tr><td>Stefen Romero	3</td></tr>
<tr><td>Andrew Romine#	16</td></tr>
<tr><td>Austin Romine	26</td></tr>
<tr><td>Sergio Romo	0</td></tr>
<tr><td>Bruce Rondon	0</td></tr>
<tr><td>Hector Rondon	0</td></tr>
<tr><td>Jorge Rondon	0</td></tr>
<tr><td>Jose Rondon	1</td></tr>
<tr><td>Adam Rosales	35</td></tr>
<tr><td>Alberto Rosario	2</td></tr>
<tr><td>Eddie Rosario*	32</td></tr>
<tr><td>Trevor Rosenthal	0</td></tr>
<tr><td>David Ross	32</td></tr>
<tr><td>Joe Ross	1</td></tr>
<tr><td>Robbie Ross*	0</td></tr>
<tr><td>Tyson Ross	0</td></tr>
<tr><td>Michael Roth*	0</td></tr>
<tr><td>Ben Rowen	0</td></tr>
<tr><td>Ryan Rua	22</td></tr>
<tr><td>Darin Ruf	9</td></tr>
<tr><td>Justin Ruggiano	1</td></tr>
<tr><td>Justin Ruggiano	6</td></tr>
<tr><td>Carlos Ruiz	12</td></tr>
<tr><td>Carlos Ruiz	3</td></tr>
<tr><td>Rio Ruiz*	2</td></tr>
<tr><td>Cameron Rupp	54</td></tr>
<tr><td>Chris Rusin*	3</td></tr>
<tr><td>Addison Russell	95</td></tr>
<tr><td>James Russell*	0</td></tr>
<tr><td>Josh Rutledge	3</td></tr>
<tr><td>Brendan Ryan	0</td></tr>
<tr><td>Kyle Ryan*	0</td></tr>
<tr><td>Hyun-Jin Ryu	0</td></tr>
<tr><td>Marc Rzepczynski*	0</td></tr>
<tr><td>Marc Rzepczynski*	0</td></tr>
<tr><td>CC Sabathia*	0</td></tr>
<tr><td>Tyler Saladino	38</td></tr>
<tr><td>Fernando Salas	0</td></tr>
<tr><td>Fernando Salas	0</td></tr>
<tr><td>Danny Salazar*	0</td></tr>
<tr><td>Chris Sale*	0</td></tr>
<tr><td>Jarrod Saltalamacchia#	38</td></tr>
<tr><td>Jeff Samardzija	9</td></tr>
<tr><td>Adrian Sampson	0</td></tr>
<tr><td>Keyvius Sampson	0</td></tr>
<tr><td>Aaron Sanchez	0</td></tr>
<tr><td>Anibal Sanchez	0</td></tr>
<tr><td>Carlos Sanchez#	21</td></tr>
<tr><td>Gary Sanchez	42</td></tr>
<tr><td>Hector Sanchez#	1</td></tr>
<tr><td>Hector Sanchez#	7</td></tr>
<tr><td>Pablo Sandoval#	0</td></tr>
<tr><td>Jerry Sands	7</td></tr>
<tr><td>Miguel Sano	66</td></tr>
<tr><td>Carlos Santana#	87</td></tr>
<tr><td>Danny Santana#	14</td></tr>
<tr><td>Domingo Santana	32</td></tr>
<tr><td>Ervin Santana	0</td></tr>
<tr><td>Hector Santiago	0</td></tr>
<tr><td>Hector Santiago	0</td></tr>
<tr><td>Luis Sardinas#	5</td></tr>
<tr><td>Luis Sardinas#	13</td></tr>
<tr><td>Michael Saunders*	57</td></tr>
<tr><td>Warwick Saupold	0</td></tr>
<tr><td>Rob Scahill*	0</td></tr>
<tr><td>Rob Scahill*	0</td></tr>
<tr><td>Logan Schafer*	1</td></tr>
<tr><td>Scott Schebler*	40</td></tr>
<tr><td>Tanner Scheppers	0</td></tr>
<tr><td>Max Scherzer	12</td></tr>
<tr><td>Ryan Schimpf*	51</td></tr>
<tr><td>Jonathan Schoop	82</td></tr>
<tr><td>A.J. Schugel	0</td></tr>
<tr><td>Bo Schultz	0</td></tr>
<tr><td>Patrick Schuster	0</td></tr>
<tr><td>Patrick Schuster	0</td></tr>
<tr><td>Kyle Schwarber*	0</td></tr>
<tr><td>Robby Scott#	0</td></tr>
<tr><td>Evan Scribner	0</td></tr>
<tr><td>Xavier Scruggs	5</td></tr>
<tr><td>Corey Seager*	72</td></tr>
<tr><td>Kyle Seager*	99</td></tr>
<tr><td>Rob Segedin	12</td></tr>
<tr><td>Jean Segura	64</td></tr>
<tr><td>Steve Selsky	7</td></tr>
<tr><td>Marcus Semien	75</td></tr>
<tr><td>Luis Severino	0</td></tr>
<tr><td>Pedro Severino	4</td></tr>
<tr><td>Richie Shaffer	4</td></tr>
<tr><td>Bryan Shaw#	0</td></tr>
<tr><td>Travis Shaw*	71</td></tr>
<tr><td>James Shields	0</td></tr>
<tr><td>James Shields	0</td></tr>
<tr><td>Braden Shipley	2</td></tr>
<tr><td>Matt Shoemaker	0</td></tr>
<tr><td>Chasen Shreve*	0</td></tr>
<tr><td>J.B. Shuck*	14</td></tr>
<tr><td>Kevin Siegrist*	0</td></tr>
<tr><td>Andrelton Simmons	44</td></tr>
<tr><td>Shae Simmons	0</td></tr>
<tr><td>Alfredo Simon	1</td></tr>
<tr><td>Tony Sipp*	0</td></tr>
<tr><td>Tyler Skaggs*	0</td></tr>
<tr><td>Blake Smith*	0</td></tr>
<tr><td>Carson Smith	0</td></tr>
<tr><td>Chris Smith	0</td></tr>
<tr><td>Jake Smith	0</td></tr>
<tr><td>Joe Smith	0</td></tr>
<tr><td>Joe Smith	0</td></tr>
<tr><td>Josh Smith	0</td></tr>
<tr><td>Kevan Smith	0</td></tr>
<tr><td>Mallex Smith*	22</td></tr>
<tr><td>Seth Smith*	63</td></tr>
<tr><td>Will Smith	0</td></tr>
<tr><td>Will Smith	0</td></tr>
<tr><td>Justin Smoak#	34</td></tr>
<tr><td>Josh Smoker*	0</td></tr>
<tr><td>Jake Smolinski	27</td></tr>
<tr><td>Drew Smyly*	0</td></tr>
<tr><td>Blake Snell*	0</td></tr>
<tr><td>Brandon Snyder	9</td></tr>
<tr><td>Miguel Socolovich	0</td></tr>
<tr><td>Donovan Solano	2</td></tr>
<tr><td>Yangervis Solarte#	71</td></tr>
<tr><td>Jorge Soler	31</td></tr>
<tr><td>Sammy Solis	0</td></tr>
<tr><td>Layne Somsen	0</td></tr>
<tr><td>Joakim Soria	0</td></tr>
<tr><td>Geovany Soto	9</td></tr>
<tr><td>Steven Souza	49</td></tr>
<tr><td>Denard Span*	53</td></tr>
<tr><td>Cory Spangenberg*	8</td></tr>
<tr><td>George Springer	82</td></tr>
<tr><td>Jacob Stallings	2</td></tr>
<tr><td>Giancarlo Stanton	74</td></tr>
<tr><td>Max Stassi	0</td></tr>
<tr><td>Robert Stephenson	0</td></tr>
<tr><td>Brock Stewart*	0</td></tr>
<tr><td>Chris Stewart	7</td></tr>
<tr><td>Drew Storen#	0</td></tr>
<tr><td>Drew Storen#	0</td></tr>
<tr><td>Trevor Story	72</td></tr>
<tr><td>Matt Strahm	0</td></tr>
<tr><td>Dan Straily	1</td></tr>
<tr><td>Stephen Strasburg	2</td></tr>
<tr><td>Chris Stratton	0</td></tr>
<tr><td>Huston Street	0</td></tr>
<tr><td>Hunter Strickland	0</td></tr>
<tr><td>Ross Stripling	1</td></tr>
<tr><td>Marcus Stroman	0</td></tr>
<tr><td>Pedro Strop	0</td></tr>
<tr><td>Drew Stubbs	3</td></tr>
<tr><td>Drew Stubbs	3</td></tr>
<tr><td>Drew Stubbs	1</td></tr>
<tr><td>Daniel Stumpf*	0</td></tr>
<tr><td>Tyler Sturdevant	0</td></tr>
<tr><td>Albert Suarez	2</td></tr>
<tr><td>Eugenio Suarez	70</td></tr>
<tr><td>Jesus Sucre	5</td></tr>
<tr><td>Eric Surkamp*	0</td></tr>
<tr><td>Andrew Susac	2</td></tr>
<tr><td>Brent Suter*	0</td></tr>
<tr><td>Ichiro Suzuki*	22</td></tr>
<tr><td>Kurt Suzuki	49</td></tr>
<tr><td>Dansby Swanson	17</td></tr>
<tr><td>Anthony Swarzak	0</td></tr>
<tr><td>Blake Swihart#	5</td></tr>
<tr><td>Noah Syndergaard*	6</td></tr>
<tr><td>Matt Szczur	24</td></tr>
<tr><td>Jameson Taillon	2</td></tr>
<tr><td>Masahiro Tanaka	0</td></tr>
<tr><td>Raimel Tapia*	3</td></tr>
<tr><td>Chris Taylor	0</td></tr>
<tr><td>Chris Taylor	7</td></tr>
<tr><td>Michael Taylor	16</td></tr>
<tr><td>Junichi Tazawa	0</td></tr>
<tr><td>Julio Teheran	2</td></tr>
<tr><td>Mark Teixeira#	44</td></tr>
<tr><td>Ruben Tejada	3</td></tr>
<tr><td>Ruben Tejada	2</td></tr>
<tr><td>Tomas Telis#	4</td></tr>
<tr><td>Ryan Tepera	0</td></tr>
<tr><td>Nick Tepesch	0</td></tr>
<tr><td>Josh Thole*	7</td></tr>
<tr><td>Jake Thompson	0</td></tr>
<tr><td>Trayce Thompson	32</td></tr>
<tr><td>Tyler Thornburg	0</td></tr>
<tr><td>Matt Thornton*	0</td></tr>
<tr><td>Chris Tillman	0</td></tr>
<tr><td>Charlie Tilson*	0</td></tr>
<tr><td>Andrew Toles*	16</td></tr>
<tr><td>Shawn Tolleson	0</td></tr>
<tr><td>Ashur Tolliver*	0</td></tr>
<tr><td>Yasmany Tomas	83</td></tr>
<tr><td>Josh Tomlin	0</td></tr>
<tr><td>Kelby Tomlinson	6</td></tr>
<tr><td>Michael Tonkin	0</td></tr>
<tr><td>Carlos Torres	0</td></tr>
<tr><td>Jose Torres*	0</td></tr>
<tr><td>Ronald Torreyes	12</td></tr>
<tr><td>Devon Travis	50</td></tr>
<tr><td>Blake Treinen	0</td></tr>
<tr><td>Andrew Triggs	0</td></tr>
<tr><td>Nick Tropeano	0</td></tr>
<tr><td>Mike Trout	100</td></tr>
<tr><td>Mark Trumbo	108</td></tr>
<tr><td>Chin-hui Tsao	0</td></tr>
<tr><td>Preston Tucker*	8</td></tr>
<tr><td>Matt Tuiasosopo	0</td></tr>
<tr><td>Sam Tuivailala	0</td></tr>
<tr><td>Troy Tulowitzki	79</td></tr>
<tr><td>Jacob Turner	0</td></tr>
<tr><td>Justin Turner	90</td></tr>
<tr><td>Trea Turner	40</td></tr>
<tr><td>Koji Uehara	0</td></tr>
<tr><td>Justin Upton	87</td></tr>
<tr><td>Melvin Upton	45</td></tr>
<tr><td>Melvin Upton	16</td></tr>
<tr><td>Jose Urena	0</td></tr>
<tr><td>Julio Urias*	2</td></tr>
<tr><td>Juan Uribe	25</td></tr>
<tr><td>Chase Utley*	52</td></tr>
<tr><td>Pat Valaika	2</td></tr>
<tr><td>Luis Valbuena*	40</td></tr>
<tr><td>Jose Valdez	0</td></tr>
<tr><td>Danny Valencia	51</td></tr>
<tr><td>Scott Van Slyke	7</td></tr>
<tr><td>Cesar Vargas	0</td></tr>
<tr><td>Jason Vargas*	0</td></tr>
<tr><td>Kennys Vargas#	20</td></tr>
<tr><td>Christian Vazquez	12</td></tr>
<tr><td>Vince Velasquez	0</td></tr>
<tr><td>Will Venable*	0</td></tr>
<tr><td>Pat Venditte*	0</td></tr>
<tr><td>Pat Venditte*	0</td></tr>
<tr><td>Yordano Ventura	0</td></tr>
<tr><td>Drew VerHagen	0</td></tr>
<tr><td>Justin Verlander	0</td></tr>
<tr><td>Logan Verrett	0</td></tr>
<tr><td>Carlos Villanueva	0</td></tr>
<tr><td>Jonathan Villar#	63</td></tr>
<tr><td>Nick Vincent	0</td></tr>
<tr><td>Arodys Vizcaino	0</td></tr>
<tr><td>Dan Vogelbach*	0</td></tr>
<tr><td>Ryan Vogelsong	1</td></tr>
<tr><td>Stephen Vogt*	56</td></tr>
<tr><td>Edinson Volquez	0</td></tr>
<tr><td>Joey Votto*	97</td></tr>
<tr><td>Michael Wacha	0</td></tr>
<tr><td>Tyler Wagner	0</td></tr>
<tr><td>Adam Wainwright	18</td></tr>
<tr><td>Kyle Waldrop*	1</td></tr>
<tr><td>Neil Walker#	55</td></tr>
<tr><td>Taijuan Walker	0</td></tr>
<tr><td>Brett Wallace*	20</td></tr>
<tr><td>Colin Walsh#	2</td></tr>
<tr><td>Zach Walters#	0</td></tr>
<tr><td>Chien-Ming Wang	0</td></tr>
<tr><td>Adam Warren	0</td></tr>
<tr><td>Adam Warren	0</td></tr>
<tr><td>Tony Watson*	0</td></tr>
<tr><td>Jered Weaver	0</td></tr>
<tr><td>Luke Weaver	0</td></tr>
<tr><td>Daniel Webb	0</td></tr>
<tr><td>Ryan Webb	0</td></tr>
<tr><td>Ryan Weber	0</td></tr>
<tr><td>Jemile Weeks#	2</td></tr>
<tr><td>Rickie Weeks	27</td></tr>
<tr><td>J.B. Wendelken	0</td></tr>
<tr><td>Joey Wendle*	11</td></tr>
<tr><td>Jayson Werth	69</td></tr>
<tr><td>Robert Whalen	0</td></tr>
<tr><td>Tyler White	28</td></tr>
<tr><td>Chase Whitley	0</td></tr>
<tr><td>Joe Wieland	0</td></tr>
<tr><td>Matt Wieters#	66</td></tr>
<tr><td>Tom Wilhelmsen	0</td></tr>
<tr><td>Tom Wilhelmsen	0</td></tr>
<tr><td>Andy Wilkins*	3</td></tr>
<tr><td>Jerome Williams	0</td></tr>
<tr><td>Mason Williams*	2</td></tr>
<tr><td>Trevor Williams	1</td></tr>
<tr><td>Mac Williamson	15</td></tr>
<tr><td>Alex Wilson	0</td></tr>
<tr><td>Bobby Wilson	2</td></tr>
<tr><td>Bobby Wilson	22</td></tr>
<tr><td>Bobby Wilson	9</td></tr>
<tr><td>Justin Wilson*	0</td></tr>
<tr><td>Tyler Wilson	0</td></tr>
<tr><td>Alex Wimmers*	0</td></tr>
<tr><td>Daniel Winkler	0</td></tr>
<tr><td>Matt Wisler	2</td></tr>
<tr><td>Chris Withrow	0</td></tr>
<tr><td>Nick Wittgren	0</td></tr>
<tr><td>Tony Wolters*	30</td></tr>
<tr><td>Kolten Wong*	23</td></tr>
<tr><td>Alex Wood	2</td></tr>
<tr><td>Blake Wood	0</td></tr>
<tr><td>Travis Wood	1</td></tr>
<tr><td>Vance Worley	0</td></tr>
<tr><td>Danny Worth	1</td></tr>
<tr><td>Daniel Wright	0</td></tr>
<tr><td>Daniel Wright	0</td></tr>
<tr><td>David Wright	14</td></tr>
<tr><td>Mike Wright	0</td></tr>
<tr><td>Steven Wright	0</td></tr>
<tr><td>Kirby Yates*	0</td></tr>
<tr><td>Christian Yelich*	98</td></tr>
<tr><td>Gabriel Ynoa	0</td></tr>
<tr><td>Michael Ynoa	0</td></tr>
<tr><td>Rafael Ynoa#	0</td></tr>
<tr><td>Chris Young	24</td></tr>
<tr><td>Chris Young	0</td></tr>
<tr><td>Eric Young#	0</td></tr>
<tr><td>Madison Younginer	0</td></tr>
<tr><td>Rob Zastryzny	0</td></tr>
<tr><td>Brad Ziegler	0</td></tr>
<tr><td>Brad Ziegler	0</td></tr>
<tr><td>Ryan Zimmerman	46</td></tr>
<tr><td>Jordan Zimmermann	0</td></tr>
<tr><td>Ben Zobrist#	76</td></tr>
<tr><td>Mike Zunino	31</td></tr>
<tr><td>Tony Zych	0</td></tr>
</table>
</body>
</html>
